Spin,Number,Type,Bet Unit,Win,Loss,Net,Unit Bal.,Next Bet,Risk,Bet Layout
0,,,0,0,0,0,0,0,0,
1,27,No Bet,0,0,0,0,0,4,-4,
2,25,Bet,4,24,-4,20,20,4,16,"2 : Street(22-24),Street(25-27)"
3,31,Bet,4,0,-4,-4,16,8,8,"2 : Street(22-24),Street(25-27)"
4,28,Bet,8,24,-8,16,32,8,24,"2 : Street(19-21),Street(25-27),Street(28-30),Street(31-33)"
5,13,Bet,8,0,-8,-8,24,12,12,"2 : Street(22-24),Street(25-27),Street(28-30),Street(31-33)"
6,7,Bet,12,0,-12,-12,12,48,-36,"2 : Street(10-12),Street(13-15),Street(22-24),Street(25-27),Street(28-30) | 2 : Street(31-33)"
7,29,Bet,48,72,-48,24,36,10,26,"6 : Street(4-6),Street(7-9),Street(10-12),Street(13-15),Street(22-24) | 6 : Street(25-27),Street(28-30),Street(31-33)"
8,33,Bet,10,0,-10,-10,26,28,-2,"2 : Street(4-6),Street(10-12),Street(13-15),Street(22-24),Street(28-30)"
9,22,Bet,28,48,-28,20,46,8,38,"4 : Street(4-6),Street(7-9),Street(10-12),Street(13-15),Street(22-24) | 4 : Street(28-30),Street(31-33)"
10,5,Bet,8,0,-8,-8,38,12,26,"2 : Street(19-21),Street(22-24),Street(28-30),Street(31-33)"
11,6,Bet,12,24,-12,12,50,6,44,"2 : Street(1-3),Street(4-6),Street(19-21),Street(22-24),Street(28-30) | 2 : Street(31-33)"
12,26,Bet,6,0,-6,-6,44,10,34,"2 : Street(1-3),Street(4-6),Street(19-21)"
13,3,Bet,10,24,-10,14,58,8,50,"2 : Street(1-3),Street(4-6),Street(13-15),Street(19-21),Street(25-27)"
14,28,Bet,8,0,-8,-8,50,12,38,"2 : Street(1-3),Street(4-6),Street(13-15),Street(25-27)"
15,36,Bet,12,0,-12,-12,38,32,6,"2 : Street(1-3),Street(4-6),Street(13-15),Street(25-27),Street(28-30) | 2 : Street(31-33)"
16,28,Bet,32,48,-32,16,54,10,44,"4 : Street(1-3),Street(4-6),Street(7-9),Street(19-21),Street(22-24) | 4 : Street(25-27),Street(28-30),Street(34-36)"
17,15,Bet,10,0,-10,-10,44,12,32,"2 : Street(7-9),Street(19-21),Street(22-24),Street(28-30),Street(34-36)"
18,33,Bet,12,24,-12,12,56,8,48,"2 : Street(4-6),Street(7-9),Street(13-15),Street(19-21),Street(28-30) | 2 : Street(31-33)"
19,34,Bet,8,0,-8,-8,48,10,38,"2 : Street(13-15),Street(22-24),Street(28-30),Street(31-33)"
20,28,Bet,10,24,-10,14,62,4,58,"2 : Street(13-15),Street(22-24),Street(28-30),Street(31-33),Street(34-36)"
21,5,Bet,4,0,-4,-4,58,8,50,"2 : Street(13-15),Street(28-30)"
22,16,Bet,8,0,-8,-8,50,24,26,"2 : Street(4-6),Street(25-27),Street(28-30),Street(31-33)"
23,12,Bet,24,48,-24,24,74,10,64,"4 : Street(1-3),Street(4-6),Street(10-12),Street(16-18),Street(28-30) | 4 : Street(34-36)"
24,6,Bet,10,24,-10,14,88,6,82,"2 : Street(4-6),Street(7-9),Street(10-12),Street(16-18),Street(28-30)"
25,15,Bet,6,0,-6,-6,82,10,72,"2 : Street(4-6),Street(7-9),Street(16-18)"
26,10,Bet,10,24,-10,14,96,6,90,"2 : Street(4-6),Street(7-9),Street(10-12),Street(13-15),Street(31-33)"
27,0,Bet,6,0,-6,-6,90,6,84,"2 : Street(4-6),Street(10-12),Street(13-15)"
28,24,Bet,6,0,-6,-6,84,10,74,"2 : Street(4-6),Street(10-12),Street(13-15)"
29,23,Bet,10,24,-10,14,98,6,92,"2 : Street(4-6),Street(10-12),Street(13-15),Street(22-24),Street(25-27)"
30,25,Bet,6,24,-6,18,116,6,110,"2 : Street(13-15),Street(22-24),Street(25-27)"
31,2,Bet,6,24,-6,18,134,8,126,"2 : Street(1-3),Street(22-24),Street(25-27)"
32,22,Bet,8,24,-8,16,150,6,144,"2 : Street(1-3),Street(22-24),Street(25-27),Street(31-33)"
33,23,Bet,6,24,-6,18,168,6,162,"2 : Street(22-24),Street(25-27),Street(31-33)"
34,1,Bet,6,0,-6,-6,162,8,154,"2 : Street(22-24),Street(25-27),Street(31-33)"
35,8,Bet,8,0,-8,-8,154,10,144,"2 : Street(1-3),Street(22-24),Street(25-27),Street(31-33)"
36,35,Bet,10,24,-10,14,168,10,158,"2 : Street(1-3),Street(7-9),Street(22-24),Street(31-33),Street(34-36)"
37,7,Bet,10,24,-10,14,182,6,176,"2 : Street(1-3),Street(7-9),Street(22-24),Street(28-30),Street(34-36)"
38,6,Bet,6,0,-6,-6,176,8,168,"2 : Street(7-9),Street(28-30),Street(34-36)"
39,33,Bet,8,0,-8,-8,168,12,156,"2 : Street(4-6),Street(7-9),Street(13-15),Street(28-30)"
40,17,Bet,12,24,-12,12,180,10,170,"2 : Street(4-6),Street(7-9),Street(10-12),Street(16-18),Street(28-30) | 2 : Street(31-33)"
41,3,Bet,10,0,-10,-10,170,14,156,"2 : Street(4-6),Street(7-9),Street(13-15),Street(16-18),Street(31-33)"
42,14,Bet,14,24,-14,10,180,16,164,"2 : Street(1-3),Street(4-6),Street(7-9),Street(13-15),Street(16-18) | 2 : Street(31-33),Street(34-36)"
43,7,Bet,16,24,-16,8,188,6,182,"2 : Street(1-3),Street(4-6),Street(7-9),Street(13-15),Street(16-18) | 2 : Street(31-33) | 4 : Street(10-12)"
44,7,Bet,6,24,-6,18,206,6,200,"2 : Street(4-6),Street(7-9),Street(10-12)"
45,16,Bet,6,0,-6,-6,200,10,190,"2 : Street(4-6),Street(7-9),Street(10-12)"
46,4,Bet,10,24,-10,14,214,8,206,"2 : Street(1-3),Street(4-6),Street(7-9),Street(10-12),Street(16-18)"
47,35,Bet,8,0,-8,-8,206,12,194,"2 : Street(4-6),Street(7-9),Street(16-18),Street(31-33)"
48,1,Bet,12,24,-12,12,218,12,206,"2 : Street(1-3),Street(4-6),Street(7-9),Street(16-18),Street(31-33) | 2 : Street(34-36)"
49,22,Bet,12,0,-12,-12,206,14,192,"2 : Street(1-3),Street(4-6),Street(7-9),Street(16-18),Street(19-21) | 2 : Street(34-36)"
50,6,Bet,14,24,-14,10,216,8,208,"2 : Street(1-3),Street(4-6),Street(7-9),Street(16-18),Street(22-24) | 2 : Street(31-33),Street(34-36)"
51,36,Bet,8,24,-8,16,232,6,226,"2 : Street(4-6),Street(7-9),Street(31-33),Street(34-36)"
52,9,Bet,6,0,-6,-6,226,8,218,"2 : Street(1-3),Street(4-6),Street(34-36)"
53,25,Bet,8,0,-8,-8,218,12,206,"2 : Street(4-6),Street(7-9),Street(22-24),Street(34-36)"
54,0,Bet,12,0,-12,-12,206,12,194,"2 : Street(1-3),Street(4-6),Street(7-9),Street(25-27),Street(31-33) | 2 : Street(34-36)"
55,34,Bet,12,24,-12,12,218,10,208,"2 : Street(1-3),Street(4-6),Street(7-9),Street(25-27),Street(31-33) | 2 : Street(34-36)"
56,35,Bet,10,24,-10,14,232,10,222,"2 : Street(1-3),Street(4-6),Street(7-9),Street(31-33),Street(34-36)"
57,33,Bet,10,24,-10,14,246,6,240,"2 : Street(1-3),Street(4-6),Street(7-9),Street(31-33),Street(34-36)"
58,2,Bet,6,0,-6,-6,240,10,230,"2 : Street(13-15),Street(31-33),Street(34-36)"
59,36,Bet,10,24,-10,14,254,8,246,"2 : Street(1-3),Street(13-15),Street(22-24),Street(31-33),Street(34-36)"
60,16,Bet,8,0,-8,-8,246,12,234,"2 : Street(13-15),Street(22-24),Street(31-33),Street(34-36)"
61,4,Bet,12,24,-12,12,258,8,250,"2 : Street(1-3),Street(4-6),Street(13-15),Street(16-18),Street(22-24) | 2 : Street(34-36)"
62,17,Bet,8,24,-8,16,274,6,268,"2 : Street(4-6),Street(7-9),Street(16-18),Street(34-36)"
63,0,Bet,6,0,-6,-6,268,6,262,"2 : Street(4-6),Street(7-9),Street(16-18)"
64,30,Bet,6,0,-6,-6,262,8,254,"2 : Street(4-6),Street(7-9),Street(16-18)"
65,2,Bet,8,0,-8,-8,254,10,244,"2 : Street(10-12),Street(16-18),Street(25-27),Street(28-30)"
66,0,Bet,10,0,-10,-10,244,10,234,"2 : Street(1-3),Street(10-12),Street(25-27),Street(28-30),Street(34-36)"
67,27,Bet,10,24,-10,14,258,10,248,"2 : Street(1-3),Street(10-12),Street(25-27),Street(28-30),Street(34-36)"
68,30,Bet,10,24,-10,14,272,6,266,"2 : Street(1-3),Street(10-12),Street(25-27),Street(28-30),Street(31-33)"
69,1,Bet,6,24,-6,18,290,6,284,"2 : Street(1-3),Street(28-30),Street(31-33)"
70,35,Bet,6,0,-6,-6,284,8,276,"2 : Street(1-3),Street(28-30),Street(31-33)"
71,1,Bet,8,24,-8,16,300,8,292,"2 : Street(1-3),Street(4-6),Street(28-30),Street(34-36)"
72,28,Bet,8,24,-8,16,316,6,310,"2 : Street(1-3),Street(4-6),Street(28-30),Street(34-36)"
73,3,Bet,6,24,-6,18,334,6,328,"2 : Street(1-3),Street(28-30),Street(34-36)"
74,7,Bet,6,0,-6,-6,328,8,320,"2 : Street(1-3),Street(28-30),Street(34-36)"
75,26,Bet,8,0,-8,-8,320,10,310,"2 : Street(1-3),Street(7-9),Street(28-30),Street(31-33)"
76,20,Bet,10,0,-10,-10,310,12,298,"2 : Street(1-3),Street(7-9),Street(25-27),Street(31-33),Street(34-36)"
77,22,Bet,12,0,-12,-12,298,16,282,"2 : Street(1-3),Street(4-6),Street(7-9),Street(19-21),Street(25-27) | 2 : Street(28-30)"
78,24,Bet,16,24,-16,8,306,14,292,"2 : Street(1-3),Street(7-9),Street(10-12),Street(16-18),Street(19-21) | 2 : Street(22-24),Street(25-27),Street(31-33)"
79,17,Bet,14,24,-14,10,316,6,310,"2 : Street(1-3),Street(10-12),Street(16-18),Street(19-21),Street(22-24) | 2 : Street(25-27),Street(31-33)"
80,18,Bet,6,24,-6,18,334,4,330,"2 : Street(16-18),Street(22-24),Street(34-36)"
81,20,Bet,4,0,-4,-4,330,8,322,"2 : Street(16-18),Street(34-36)"
82,23,Bet,8,24,-8,16,346,6,340,"2 : Street(16-18),Street(19-21),Street(22-24),Street(34-36)"
83,16,Bet,6,24,-6,18,364,6,358,"2 : Street(16-18),Street(19-21),Street(22-24)"
84,30,Bet,6,0,-6,-6,358,8,350,"2 : Street(16-18),Street(19-21),Street(22-24)"
85,12,Bet,8,0,-8,-8,350,10,340,"2 : Street(1-3),Street(16-18),Street(22-24),Street(28-30)"
86,11,Bet,10,24,-10,14,364,8,356,"2 : Street(7-9),Street(10-12),Street(13-15),Street(16-18),Street(28-30)"
87,9,Bet,8,24,-8,16,380,6,374,"2 : Street(7-9),Street(10-12),Street(13-15),Street(16-18)"
88,8,Bet,6,24,-6,18,398,4,394,"2 : Street(7-9),Street(10-12),Street(25-27)"
89,23,Bet,4,0,-4,-4,394,8,386,"2 : Street(7-9),Street(25-27)"
90,21,Bet,8,0,-8,-8,386,12,374,"2 : Street(7-9),Street(16-18),Street(22-24),Street(25-27)"
91,23,Bet,12,24,-12,12,398,10,388,"2 : Street(7-9),Street(16-18),Street(19-21),Street(22-24),Street(25-27) | 2 : Street(28-30)"
92,29,Bet,10,24,-10,14,412,6,406,"2 : Street(16-18),Street(19-21),Street(22-24),Street(25-27),Street(28-30)"
93,31,Bet,6,0,-6,-6,406,10,396,"2 : Street(10-12),Street(22-24),Street(28-30)"
94,21,Bet,10,0,-10,-10,396,12,384,"2 : Street(4-6),Street(7-9),Street(22-24),Street(28-30),Street(31-33)"
95,26,Bet,12,0,-12,-12,384,12,372,"2 : Street(4-6),Street(7-9),Street(19-21),Street(22-24),Street(28-30) | 2 : Street(31-33)"
96,11,Bet,12,0,-12,-12,372,18,354,"2 : Street(4-6),Street(19-21),Street(22-24),Street(25-27),Street(28-30) | 2 : Street(31-33)"
97,1,Bet,18,0,-18,-18,354,20,334,"2 : Street(4-6),Street(7-9),Street(10-12),Street(16-18),Street(19-21) | 2 : Street(22-24),Street(25-27),Street(28-30),Street(31-33)"
98,14,Bet,20,0,-20,-20,334,22,312,"2 : Street(1-3),Street(4-6),Street(7-9),Street(10-12),Street(16-18) | 2 : Street(19-21),Street(22-24),Street(25-27),Street(28-30),Street(31-33)"
99,23,Bet,22,24,-22,2,336,4,332,"2 : Street(1-3),Street(4-6),Street(7-9),Street(10-12),Street(13-15) | 2 : Street(19-21),Street(22-24),Street(25-27),Street(28-30),Street(31-33) | 2 : Street(34-36)"
100,1,Bet,4,0,-4,-4,332,6,326,"2 : Street(22-24),Street(28-30)"
101,21,Bet,6,0,-6,-6,326,10,316,"2 : Street(1-3),Street(22-24),Street(28-30)"
102,10,Bet,10,0,-10,-10,316,14,302,"2 : Street(1-3),Street(19-21),Street(22-24),Street(25-27),Street(28-30)"
103,9,Bet,14,0,-14,-14,302,16,286,"2 : Street(1-3),Street(10-12),Street(13-15),Street(19-21),Street(22-24) | 2 : Street(25-27),Street(28-30)"
104,19,Bet,16,24,-16,8,310,8,302,"2 : Street(1-3),Street(7-9),Street(10-12),Street(13-15),Street(19-21) | 2 : Street(22-24),Street(28-30),Street(31-33)"
105,18,Bet,8,24,-8,16,326,8,318,"2 : Street(1-3),Street(7-9),Street(16-18),Street(19-21)"
106,5,Bet,8,0,-8,-8,318,12,306,"2 : Street(7-9),Street(13-15),Street(16-18),Street(19-21)"
107,33,Bet,12,0,-12,-12,306,14,292,"2 : Street(1-3),Street(4-6),Street(7-9),Street(13-15),Street(16-18) | 2 : Street(19-21)"
108,8,Bet,14,24,-14,10,316,4,312,"2 : Street(4-6),Street(7-9),Street(10-12),Street(16-18),Street(19-21) | 2 : Street(28-30),Street(31-33)"
109,19,Bet,4,24,-4,20,336,6,330,"2 : Street(7-9),Street(19-21)"
110,19,Bet,6,24,-6,18,354,4,350,"2 : Street(7-9),Street(16-18),Street(19-21)"
111,10,Bet,4,0,-4,-4,350,8,342,"2 : Street(16-18),Street(19-21)"
112,8,Bet,8,0,-8,-8,342,10,332,"2 : Street(1-3),Street(4-6),Street(10-12),Street(19-21)"
113,9,Bet,10,24,-10,14,356,2,354,"2 : Street(1-3),Street(4-6),Street(7-9),Street(10-12),Street(19-21)"
114,27,Bet,2,0,-2,-2,354,6,348,2 : Street(7-9)
115,11,Bet,6,0,-6,-6,348,8,340,"2 : Street(7-9),Street(22-24),Street(25-27)"
116,7,Bet,8,24,-8,16,364,4,360,"2 : Street(7-9),Street(10-12),Street(22-24),Street(25-27)"
117,36,Bet,4,0,-4,-4,360,8,352,"2 : Street(7-9),Street(25-27)"
118,8,Bet,8,24,-8,16,376,8,368,"2 : Street(7-9),Street(10-12),Street(25-27),Street(34-36)"
119,16,Bet,8,0,-8,-8,368,10,358,"2 : Street(7-9),Street(10-12),Street(25-27),Street(34-36)"
120,29,Bet,10,0,-10,-10,358,8,350,"2 : Street(7-9),Street(10-12),Street(16-18),Street(25-27),Street(34-36)"
121,30,Bet,8,24,-8,16,374,4,370,"2 : Street(7-9),Street(16-18),Street(22-24),Street(28-30)"
122,9,Bet,4,0,-4,-4,370,6,364,"2 : Street(22-24),Street(28-30)"
123,24,Bet,6,24,-6,18,388,8,380,"2 : Street(7-9),Street(22-24),Street(28-30)"
124,1,Bet,8,0,-8,-8,380,12,368,"2 : Street(7-9),Street(13-15),Street(22-24),Street(28-30)"
125,29,Bet,12,24,-12,12,392,8,384,"2 : Street(1-3),Street(4-6),Street(7-9),Street(13-15),Street(22-24) | 2 : Street(28-30)"
126,32,Bet,8,0,-8,-8,384,12,372,"2 : Street(4-6),Street(7-9),Street(13-15),Street(28-30)"
127,34,Bet,12,0,-12,-12,372,16,356,"2 : Street(4-6),Street(13-15),Street(19-21),Street(22-24),Street(28-30) | 2 : Street(31-33)"
128,32,Bet,16,24,-16,8,380,14,366,"2 : Street(1-3),Street(4-6),Street(13-15),Street(16-18),Street(19-21) | 2 : Street(28-30),Street(31-33),Street(34-36)"
129,16,Bet,14,24,-14,10,390,6,384,"2 : Street(1-3),Street(4-6),Street(13-15),Street(16-18),Street(19-21) | 2 : Street(31-33),Street(34-36)"
130,34,Bet,6,0,-6,-6,384,8,376,"2 : Street(7-9),Street(16-18),Street(31-33)"
131,17,Bet,8,24,-8,16,400,8,392,"2 : Street(7-9),Street(16-18),Street(31-33),Street(34-36)"
132,22,Bet,8,0,-8,-8,392,10,382,"2 : Street(7-9),Street(16-18),Street(31-33),Street(34-36)"
133,27,Bet,10,0,-10,-10,382,12,370,"2 : Street(1-3),Street(7-9),Street(16-18),Street(22-24),Street(34-36)"
134,27,Bet,12,24,-12,12,394,12,382,"2 : Street(1-3),Street(10-12),Street(16-18),Street(22-24),Street(25-27) | 2 : Street(28-30)"
0,,,0,0,0,0,0,4,-4,
136,9,Bet,4,0,-4,-4,402,8,394,"2 : Street(16-18),Street(19-21)"
137,8,Bet,8,24,-8,16,418,6,412,"2 : Street(7-9),Street(10-12),Street(16-18),Street(19-21)"
138,28,Bet,6,0,-6,-6,412,10,402,"2 : Street(4-6),Street(7-9),Street(13-15)"
139,23,Bet,10,0,-10,-10,402,14,388,"2 : Street(1-3),Street(7-9),Street(10-12),Street(25-27),Street(28-30)"
140,0,Bet,14,0,-14,-14,388,0,388,"2 : Street(4-6),Street(7-9),Street(16-18),Street(19-21),Street(22-24) | 2 : Street(25-27),Street(28-30)"
141,34,No Bet,0,0,0,0,388,0,388,
142,5,No Bet,0,0,0,0,388,0,388,
143,12,No Bet,0,0,0,0,388,0,388,
144,3,No Bet,0,0,0,0,388,0,388,
145,17,No Bet,0,0,0,0,388,0,388,
146,17,No Bet,0,0,0,0,388,4,384,
147,9,Bet,4,24,-4,20,408,6,402,"2 : Street(7-9),Street(16-18)"
148,8,Bet,6,24,-6,18,426,4,422,"2 : Street(7-9),Street(16-18),Street(28-30)"
149,28,Bet,4,24,-4,20,446,6,440,"2 : Street(7-9),Street(28-30)"
150,23,Bet,6,24,-6,18,464,8,456,"2 : Street(7-9),Street(22-24),Street(28-30)"
151,0,Bet,8,0,-8,-8,456,8,448,"2 : Street(7-9),Street(22-24),Street(28-30),Street(34-36)"
152,34,Bet,8,24,-8,16,472,10,462,"2 : Street(7-9),Street(22-24),Street(28-30),Street(34-36)"
153,14,Bet,10,0,-10,-10,462,14,448,"2 : Street(4-6),Street(7-9),Street(22-24),Street(28-30),Street(34-36)"
154,30,Bet,14,24,-14,10,472,8,464,"2 : Street(4-6),Street(7-9),Street(10-12),Street(13-15),Street(22-24) | 2 : Street(28-30),Street(34-36)"
155,17,Bet,8,0,-8,-8,464,12,452,"2 : Street(4-6),Street(10-12),Street(22-24),Street(28-30)"
156,16,Bet,12,24,-12,12,476,10,466,"2 : Street(4-6),Street(7-9),Street(10-12),Street(16-18),Street(28-30) | 2 : Street(34-36)"
157,34,Bet,10,24,-10,14,490,6,484,"2 : Street(4-6),Street(7-9),Street(10-12),Street(16-18),Street(34-36)"
158,30,Bet,6,0,-6,-6,484,8,476,"2 : Street(13-15),Street(16-18),Street(34-36)"
159,6,Bet,8,0,-8,-8,476,10,466,"2 : Street(13-15),Street(16-18),Street(28-30),Street(34-36)"
160,34,Bet,10,24,-10,14,490,4,486,"2 : Street(4-6),Street(10-12),Street(16-18),Street(28-30),Street(34-36)"
161,26,Bet,4,0,-4,-4,486,8,478,"2 : Street(28-30),Street(34-36)"
162,33,Bet,8,0,-8,-8,478,10,468,"2 : Street(4-6),Street(19-21),Street(25-27),Street(34-36)"
163,28,Bet,10,0,-10,-10,468,14,454,"2 : Street(10-12),Street(19-21),Street(25-27),Street(31-33),Street(34-36)"
164,13,Bet,14,0,-14,-14,454,0,454,"2 : Street(4-6),Street(10-12),Street(19-21),Street(25-27),Street(28-30) | 2 : Street(31-33),Street(34-36)"
165,35,No Bet,0,0,0,0,454,0,454,
166,15,No Bet,0,0,0,0,454,6,448,
167,17,Bet,6,0,-6,-6,448,10,438,"2 : Street(13-15),Street(25-27),Street(34-36)"
168,34,Bet,10,24,-10,14,462,10,452,"2 : Street(4-6),Street(13-15),Street(16-18),Street(31-33),Street(34-36)"
169,8,Bet,10,0,-10,-10,452,12,440,"2 : Street(4-6),Street(13-15),Street(16-18),Street(31-33),Street(34-36)"
170,10,Bet,12,0,-12,-12,440,14,426,"2 : Street(7-9),Street(16-18),Street(22-24),Street(25-27),Street(28-30) | 2 : Street(34-36)"
171,5,Bet,14,24,-14,10,450,10,440,"2 : Street(1-3),Street(4-6),Street(7-9),Street(10-12),Street(13-15) | 2 : Street(31-33),Street(34-36)"
172,33,Bet,10,0,-10,-10,440,14,426,"2 : Street(4-6),Street(7-9),Street(10-12),Street(25-27),Street(34-36)"
173,28,Bet,14,24,-14,10,450,12,438,"2 : Street(4-6),Street(7-9),Street(10-12),Street(25-27),Street(28-30) | 2 : Street(31-33),Street(34-36)"
174,2,Bet,12,0,-12,-12,438,18,420,"2 : Street(4-6),Street(7-9),Street(10-12),Street(28-30),Street(31-33) | 2 : Street(34-36)"
175,3,Bet,18,24,-18,6,444,6,438,"2 : Street(1-3),Street(4-6),Street(7-9),Street(10-12),Street(16-18) | 2 : Street(22-24),Street(28-30),Street(31-33),Street(34-36)"
176,32,Bet,6,0,-6,-6,438,10,428,"2 : Street(1-3),Street(16-18),Street(22-24)"
177,27,Bet,10,0,-10,-10,428,12,416,"2 : Street(1-3),Street(16-18),Street(22-24),Street(28-30),Street(31-33)"
178,32,Bet,12,24,-12,12,440,12,428,"2 : Street(1-3),Street(13-15),Street(22-24),Street(25-27),Street(31-33) | 2 : Street(34-36)"
179,19,Bet,12,0,-12,-12,428,14,414,"2 : Street(1-3),Street(13-15),Street(22-24),Street(25-27),Street(31-33) | 2 : Street(34-36)"
180,17,Bet,14,24,-14,10,438,8,430,"2 : Street(7-9),Street(13-15),Street(16-18),Street(19-21),Street(22-24) | 2 : Street(25-27),Street(31-33)"
181,15,Bet,8,0,-8,-8,430,12,418,"2 : Street(16-18),Street(19-21),Street(31-33),Street(34-36)"
182,32,Bet,12,24,-12,12,442,8,434,"2 : Street(7-9),Street(13-15),Street(16-18),Street(19-21),Street(31-33) | 2 : Street(34-36)"
183,27,Bet,8,0,-8,-8,434,12,422,"2 : Street(7-9),Street(19-21),Street(31-33),Street(34-36)"
184,0,Bet,12,0,-12,-12,422,12,410,"2 : Street(7-9),Street(16-18),Street(19-21),Street(25-27),Street(31-33) | 2 : Street(34-36)"
185,32,Bet,12,24,-12,12,434,12,422,"2 : Street(7-9),Street(16-18),Street(19-21),Street(25-27),Street(31-33) | 2 : Street(34-36)"
186,29,Bet,12,0,-12,-12,422,14,408,"2 : Street(7-9),Street(16-18),Street(19-21),Street(25-27),Street(31-33) | 2 : Street(34-36)"
187,26,Bet,14,0,-14,-14,408,0,408,"2 : Street(1-3),Street(7-9),Street(13-15),Street(16-18),Street(28-30) | 2 : Street(31-33),Street(34-36)"
188,15,No Bet,0,0,0,0,408,8,400,
189,11,Bet,8,0,-8,-8,400,12,388,"2 : Street(13-15),Street(25-27),Street(28-30),Street(31-33)"
190,7,Bet,12,0,-12,-12,388,0,388,"2 : Street(4-6),Street(10-12),Street(13-15),Street(25-27),Street(28-30) | 2 : Street(31-33)"
191,16,No Bet,0,0,0,0,388,0,388,
192,24,No Bet,0,0,0,0,388,0,388,
193,16,No Bet,0,0,0,0,388,0,388,
194,28,No Bet,0,0,0,0,388,0,388,
195,26,No Bet,0,0,0,0,388,0,388,
196,5,No Bet,0,0,0,0,388,0,388,
197,32,No Bet,0,0,0,0,388,0,388,
198,13,No Bet,0,0,0,0,388,0,388,
199,27,No Bet,0,0,0,0,388,6,382,
200,11,Bet,6,24,-6,18,406,6,400,"2 : Street(4-6),Street(10-12),Street(25-27)"
201,17,Bet,6,0,-6,-6,400,10,390,"2 : Street(7-9),Street(10-12),Street(25-27)"
202,34,Bet,10,0,-10,-10,390,14,376,"2 : Street(7-9),Street(10-12),Street(16-18),Street(25-27),Street(28-30)"
203,10,Bet,14,24,-14,10,400,10,390,"2 : Street(1-3),Street(4-6),Street(10-12),Street(16-18),Street(25-27) | 2 : Street(28-30),Street(34-36)"
204,36,Bet,10,0,-10,-10,390,10,380,"2 : Street(1-3),Street(4-6),Street(10-12),Street(16-18),Street(22-24)"
205,32,Bet,10,0,-10,-10,380,12,368,"2 : Street(1-3),Street(4-6),Street(10-12),Street(22-24),Street(34-36)"
206,6,Bet,12,24,-12,12,392,10,382,"2 : Street(1-3),Street(4-6),Street(10-12),Street(22-24),Street(31-33) | 2 : Street(34-36)"
207,24,Bet,10,0,-10,-10,382,14,368,"2 : Street(4-6),Street(10-12),Street(13-15),Street(31-33),Street(34-36)"
208,19,Bet,14,0,-14,-14,368,0,368,"2 : Street(4-6),Street(10-12),Street(22-24),Street(25-27),Street(28-30) | 2 : Street(31-33),Street(34-36)"
209,27,No Bet,0,0,0,0,368,0,368,
210,27,No Bet,0,0,0,0,368,0,368,
211,16,No Bet,0,0,0,0,368,6,362,
212,34,Bet,6,0,-6,-6,362,10,352,"2 : Street(10-12),Street(16-18),Street(25-27)"
213,25,Bet,10,24,-10,14,376,8,368,"2 : Street(10-12),Street(16-18),Street(25-27),Street(31-33),Street(34-36)"
214,31,Bet,8,24,-8,16,392,6,386,"2 : Street(10-12),Street(16-18),Street(25-27),Street(31-33)"
215,29,Bet,6,0,-6,-6,386,10,376,"2 : Street(10-12),Street(25-27),Street(31-33)"
216,0,Bet,10,0,-10,-10,376,10,366,"2 : Street(13-15),Street(22-24),Street(25-27),Street(28-30),Street(31-33)"
217,15,Bet,10,24,-10,14,390,8,382,"2 : Street(13-15),Street(22-24),Street(25-27),Street(28-30),Street(31-33)"
218,2,Bet,8,0,-8,-8,382,14,368,"2 : Street(13-15),Street(25-27),Street(28-30),Street(31-33)"
219,3,Bet,14,24,-14,10,392,6,386,"2 : Street(1-3),Street(4-6),Street(7-9),Street(13-15),Street(25-27) | 2 : Street(28-30),Street(31-33)"
220,19,Bet,6,0,-6,-6,386,10,376,"2 : Street(1-3),Street(4-6),Street(7-9)"
221,13,Bet,10,0,-10,-10,376,12,364,"2 : Street(1-3),Street(4-6),Street(7-9),Street(16-18),Street(19-21)"
222,29,Bet,12,0,-12,-12,364,4,360,"2 : Street(1-3),Street(4-6),Street(7-9),Street(13-15),Street(16-18) | 2 : Street(19-21)"
223,2,Bet,4,0,-4,-4,360,6,354,"2 : Street(25-27),Street(28-30)"
224,1,Bet,6,24,-6,18,378,6,372,"2 : Street(1-3),Street(25-27),Street(28-30)"
225,28,Bet,6,24,-6,18,396,4,392,"2 : Street(1-3),Street(25-27),Street(28-30)"
226,16,Bet,4,0,-4,-4,392,8,384,"2 : Street(1-3),Street(28-30)"
227,28,Bet,8,24,-8,16,408,4,404,"2 : Street(1-3),Street(13-15),Street(16-18),Street(28-30)"
228,16,Bet,4,24,-4,20,428,4,424,"2 : Street(16-18),Street(28-30)"
229,28,Bet,4,24,-4,20,448,4,444,"2 : Street(16-18),Street(28-30)"
230,27,Bet,4,0,-4,-4,444,6,438,"2 : Street(16-18),Street(28-30)"
231,16,Bet,6,0,-6,-6,438,8,430,"2 : Street(22-24),Street(25-27),Street(28-30)"
232,30,Bet,8,24,-8,16,454,4,450,"2 : Street(16-18),Street(22-24),Street(25-27),Street(28-30)"
233,5,Bet,4,0,-4,-4,450,8,442,"2 : Street(25-27),Street(28-30)"
234,15,Bet,8,0,-8,-8,442,10,432,"2 : Street(1-3),Street(4-6),Street(16-18),Street(28-30)"
235,15,Bet,10,24,-10,14,456,8,448,"2 : Street(4-6),Street(10-12),Street(13-15),Street(25-27),Street(28-30)"
236,7,Bet,8,0,-8,-8,448,12,436,"2 : Street(10-12),Street(13-15),Street(25-27),Street(28-30)"
237,26,Bet,12,0,-12,-12,436,14,422,"2 : Street(1-3),Street(4-6),Street(7-9),Street(10-12),Street(13-15) | 2 : Street(16-18)"
238,27,Bet,14,24,-14,10,446,2,444,"2 : Street(1-3),Street(7-9),Street(10-12),Street(13-15),Street(16-18) | 2 : Street(25-27),Street(28-30)"
239,9,Bet,2,0,-2,-2,444,4,440,2 : Street(25-27)
240,6,Bet,4,0,-4,-4,440,6,434,"2 : Street(7-9),Street(25-27)"
241,29,Bet,6,0,-6,-6,434,10,424,"2 : Street(4-6),Street(7-9),Street(25-27)"
242,7,Bet,10,24,-10,14,448,10,438,"2 : Street(4-6),Street(7-9),Street(13-15),Street(25-27),Street(28-30)"
243,31,Bet,10,0,-10,-10,438,12,426,"2 : Street(4-6),Street(7-9),Street(13-15),Street(25-27),Street(28-30)"
244,31,Bet,12,24,-12,12,450,2,448,"2 : Street(4-6),Street(7-9),Street(22-24),Street(25-27),Street(28-30) | 2 : Street(31-33)"
245,30,Bet,2,0,-2,-2,448,6,442,2 : Street(31-33)
246,30,Bet,6,24,-6,18,466,2,464,"2 : Street(7-9),Street(28-30),Street(31-33)"
247,24,Bet,2,0,-2,-2,464,6,458,2 : Street(28-30)
248,18,Bet,6,0,-6,-6,458,10,448,"2 : Street(19-21),Street(22-24),Street(28-30)"
249,17,Bet,10,24,-10,14,472,2,470,"2 : Street(13-15),Street(16-18),Street(19-21),Street(22-24),Street(28-30)"
250,32,Bet,2,0,-2,-2,470,6,464,2 : Street(16-18)
251,33,Bet,6,24,-6,18,488,2,486,"2 : Street(16-18),Street(28-30),Street(31-33)"
252,3,Bet,2,0,-2,-2,486,6,480,2 : Street(31-33)
253,18,Bet,6,0,-6,-6,480,8,472,"2 : Street(1-3),Street(13-15),Street(31-33)"
254,26,Bet,8,0,-8,-8,472,12,460,"2 : Street(1-3),Street(13-15),Street(16-18),Street(31-33)"
255,26,Bet,12,24,-12,12,484,2,482,"2 : Street(1-3),Street(4-6),Street(13-15),Street(16-18),Street(25-27) | 2 : Street(31-33)"
256,14,Bet,2,0,-2,-2,482,6,476,2 : Street(25-27)
257,30,Bet,6,0,-6,-6,476,10,466,"2 : Street(4-6),Street(13-15),Street(25-27)"
258,31,Bet,10,0,-10,-10,466,14,452,"2 : Street(4-6),Street(13-15),Street(22-24),Street(25-27),Street(28-30)"
259,5,Bet,14,24,-14,10,476,12,464,"2 : Street(1-3),Street(4-6),Street(13-15),Street(22-24),Street(25-27) | 2 : Street(28-30),Street(31-33)"
260,23,Bet,12,0,-12,-12,464,16,448,"2 : Street(4-6),Street(7-9),Street(13-15),Street(25-27),Street(28-30) | 2 : Street(31-33)"
261,20,Bet,16,0,-16,-16,448,0,448,"2 : Street(1-3),Street(4-6),Street(7-9),Street(13-15),Street(22-24) | 2 : Street(25-27),Street(28-30),Street(31-33)"
262,26,No Bet,0,0,0,0,448,0,448,
263,9,No Bet,0,0,0,0,448,0,448,
264,2,No Bet,0,0,0,0,448,8,440,
265,10,Bet,8,0,-8,-8,440,12,428,"2 : Street(1-3),Street(7-9),Street(16-18),Street(25-27)"
266,33,Bet,12,0,-12,-12,428,0,428,"2 : Street(1-3),Street(7-9),Street(10-12),Street(13-15),Street(16-18) | 2 : Street(25-27)"
267,23,No Bet,0,0,0,0,428,0,428,
268,21,No Bet,0,0,0,0,428,14,414,
269,14,Bet,14,0,-14,-14,414,0,414,"2 : Street(1-3),Street(7-9),Street(10-12),Street(19-21),Street(22-24) | 2 : Street(25-27),Street(31-33)"
270,17,No Bet,0,0,0,0,414,0,414,
271,7,No Bet,0,0,0,0,414,10,404,
272,29,Bet,10,24,-10,14,428,6,422,"2 : Street(1-3),Street(4-6),Street(7-9),Street(10-12),Street(28-30)"
273,29,Bet,6,24,-6,18,446,4,442,"2 : Street(4-6),Street(7-9),Street(28-30)"
274,3,Bet,4,0,-4,-4,442,8,434,"2 : Street(4-6),Street(28-30)"
275,33,Bet,8,0,-8,-8,434,12,422,"2 : Street(1-3),Street(4-6),Street(10-12),Street(28-30)"
276,3,Bet,12,24,-12,12,446,10,436,"2 : Street(1-3),Street(4-6),Street(10-12),Street(22-24),Street(28-30) | 2 : Street(31-33)"
277,20,Bet,10,0,-10,-10,436,12,424,"2 : Street(1-3),Street(4-6),Street(10-12),Street(22-24),Street(31-33)"
278,15,Bet,12,24,-12,12,448,8,440,"2 : Street(1-3),Street(4-6),Street(10-12),Street(13-15),Street(19-21) | 2 : Street(22-24)"
279,33,Bet,8,0,-8,-8,440,10,430,"2 : Street(1-3),Street(13-15),Street(16-18),Street(19-21)"
280,16,Bet,10,24,-10,14,454,12,442,"2 : Street(1-3),Street(13-15),Street(16-18),Street(19-21),Street(31-33)"
281,17,Bet,12,24,-12,12,466,4,462,"2 : Street(1-3),Street(7-9),Street(13-15),Street(16-18),Street(19-21) | 2 : Street(31-33)"
282,35,Bet,4,0,-4,-4,462,8,454,"2 : Street(7-9),Street(16-18)"
283,32,Bet,8,0,-8,-8,454,10,444,"2 : Street(7-9),Street(16-18),Street(28-30),Street(34-36)"
284,28,Bet,10,24,-10,14,468,10,458,"2 : Street(7-9),Street(16-18),Street(28-30),Street(31-33),Street(34-36)"
285,30,Bet,10,24,-10,14,482,6,476,"2 : Street(7-9),Street(16-18),Street(28-30),Street(31-33),Street(34-36)"
286,4,Bet,6,0,-6,-6,476,10,466,2 : Street(1-3) | 4 : Street(28-30)
287,6,Bet,10,24,-10,14,490,2,488,"2 : Street(4-6),Street(19-21),Street(25-27) | 4 : Street(28-30)"
288,30,Bet,2,0,-2,-2,488,4,484,2 : Street(4-6)
289,28,Bet,4,24,-4,20,508,2,506,"2 : Street(4-6),Street(28-30)"
290,27,Bet,2,0,-2,-2,506,6,500,2 : Street(28-30)
291,13,Bet,6,0,-6,-6,500,10,490,"2 : Street(10-12),Street(25-27),Street(28-30)"
292,28,Bet,10,24,-10,14,514,8,506,"2 : Street(10-12),Street(13-15),Street(16-18),Street(25-27),Street(28-30)"
293,14,Bet,8,0,-8,-8,506,10,496,"2 : Street(10-12),Street(16-18),Street(25-27),Street(28-30)"
294,22,Bet,10,0,-10,-10,496,12,484,"2 : Street(10-12),Street(13-15),Street(16-18),Street(25-27),Street(28-30)"
295,0,Bet,12,0,-12,-12,484,12,472,"2 : Street(7-9),Street(10-12),Street(13-15),Street(22-24),Street(28-30) | 2 : Street(34-36)"
296,12,Bet,12,24,-12,12,496,10,486,"2 : Street(7-9),Street(10-12),Street(13-15),Street(22-24),Street(28-30) | 2 : Street(34-36)"
297,8,Bet,10,24,-10,14,510,12,498,"2 : Street(7-9),Street(10-12),Street(13-15),Street(22-24),Street(28-30)"
298,18,Bet,12,0,-12,-12,498,0,498,"2 : Street(1-3),Street(7-9),Street(10-12),Street(13-15),Street(22-24) | 2 : Street(28-30)"
299,28,No Bet,0,0,0,0,498,8,490,
300,22,Bet,8,0,-8,-8,490,12,478,"2 : Street(1-3),Street(13-15),Street(28-30),Street(34-36)"
301,3,Bet,12,24,-12,12,502,6,496,"2 : Street(1-3),Street(10-12),Street(13-15),Street(22-24),Street(28-30) | 2 : Street(34-36)"
302,22,Bet,6,24,-6,18,520,6,514,"2 : Street(1-3),Street(19-21),Street(22-24)"
303,32,Bet,6,0,-6,-6,514,8,506,"2 : Street(1-3),Street(19-21),Street(22-24)"
304,2,Bet,8,0,-8,-8,506,10,496,"2 : Street(4-6),Street(19-21),Street(22-24),Street(31-33)"
305,32,Bet,10,24,-10,14,520,4,516,"2 : Street(1-3),Street(4-6),Street(19-21),Street(22-24),Street(31-33)"
306,2,Bet,4,24,-4,20,540,4,536,"2 : Street(1-3),Street(31-33)"
307,7,Bet,4,0,-4,-4,536,8,528,"2 : Street(1-3),Street(31-33)"
308,1,Bet,8,24,-8,16,552,4,548,"2 : Street(1-3),Street(7-9),Street(16-18),Street(31-33)"
309,1,Bet,4,24,-4,20,572,4,568,"2 : Street(1-3),Street(7-9)"
310,35,Bet,4,0,-4,-4,568,6,562,"2 : Street(1-3),Street(7-9)"
311,18,Bet,6,0,-6,-6,562,10,552,"2 : Street(1-3),Street(4-6),Street(34-36)"
312,24,Bet,10,0,-10,-10,552,0,552,"2 : Street(1-3),Street(4-6),Street(16-18),Street(28-30),Street(34-36)"
313,16,No Bet,0,0,0,0,552,4,548,
314,2,Bet,4,0,-4,-4,548,6,542,"2 : Street(16-18),Street(22-24)"
315,31,Bet,6,0,-6,-6,542,10,532,"2 : Street(1-3),Street(16-18),Street(34-36)"
316,34,Bet,10,0,-10,-10,532,12,520,"2 : Street(1-3),Street(7-9),Street(16-18),Street(22-24),Street(31-33)"
317,33,Bet,12,24,-12,12,544,4,540,"2 : Street(1-3),Street(7-9),Street(16-18),Street(22-24),Street(31-33) | 2 : Street(34-36)"
318,25,Bet,4,0,-4,-4,540,8,532,"2 : Street(31-33),Street(34-36)"
319,8,Bet,8,0,-8,-8,532,10,522,"2 : Street(25-27),Street(31-33) | 4 : Street(13-15)"
320,18,Bet,10,0,-10,-10,522,14,508,"2 : Street(7-9),Street(13-15),Street(22-24),Street(25-27),Street(31-33)"
321,5,Bet,14,0,-14,-14,508,0,508,"2 : Street(1-3),Street(7-9),Street(13-15),Street(16-18),Street(22-24) | 2 : Street(25-27),Street(31-33)"
322,10,No Bet,0,0,0,0,508,0,508,
323,34,No Bet,0,0,0,0,508,0,508,
324,33,No Bet,0,0,0,0,508,4,504,
325,32,Bet,4,24,-4,20,528,4,524,"2 : Street(25-27),Street(31-33)"
326,5,Bet,4,0,-4,-4,524,8,516,"2 : Street(25-27),Street(31-33)"
327,22,Bet,8,0,-8,-8,516,12,504,"2 : Street(4-6),Street(10-12),Street(25-27),Street(31-33)"
328,24,Bet,12,24,-12,12,528,2,526,"2 : Street(1-3),Street(4-6),Street(7-9),Street(22-24),Street(31-33) | 2 : Street(34-36)"
329,19,Bet,2,0,-2,-2,526,6,520,2 : Street(22-24)
330,22,Bet,6,24,-6,18,544,6,538,"2 : Street(13-15),Street(19-21),Street(22-24)"
331,6,Bet,6,0,-6,-6,538,8,530,"2 : Street(13-15),Street(19-21),Street(22-24)"
332,3,Bet,8,0,-8,-8,530,10,520,"2 : Street(4-6),Street(13-15),Street(19-21),Street(22-24)"
333,35,Bet,10,0,-10,-10,520,0,520,"2 : Street(1-3),Street(4-6),Street(13-15),Street(22-24),Street(25-27)"
334,32,No Bet,0,0,0,0,520,0,520,
335,11,No Bet,0,0,0,0,520,0,520,
336,11,No Bet,0,0,0,0,520,6,514,
337,32,Bet,6,0,-6,-6,514,8,506,"2 : Street(10-12),Street(19-21),Street(22-24)"
338,23,Bet,8,24,-8,16,530,8,522,"2 : Street(10-12),Street(19-21),Street(22-24),Street(31-33)"
339,23,Bet,8,24,-8,16,546,4,542,"2 : Street(4-6),Street(10-12),Street(22-24),Street(31-33)"
340,24,Bet,4,24,-4,20,566,2,564,"2 : Street(4-6),Street(22-24)"
341,17,Bet,2,0,-2,-2,564,6,558,2 : Street(22-24)
342,22,Bet,6,24,-6,18,582,6,576,"2 : Street(16-18),Street(19-21),Street(22-24)"
343,6,Bet,6,0,-6,-6,576,8,568,"2 : Street(16-18),Street(19-21),Street(22-24)"
344,3,Bet,8,24,-8,16,592,8,584,"2 : Street(1-3),Street(4-6),Street(19-21),Street(22-24)"
345,35,Bet,8,24,-8,16,608,10,598,"2 : Street(1-3),Street(4-6),Street(22-24),Street(34-36)"
346,32,Bet,10,0,-10,-10,598,14,584,"2 : Street(1-3),Street(4-6),Street(10-12),Street(22-24),Street(34-36)"
347,11,Bet,14,24,-14,10,608,14,594,"2 : Street(1-3),Street(4-6),Street(10-12),Street(16-18),Street(22-24) | 2 : Street(31-33),Street(34-36)"
348,11,Bet,14,24,-14,10,618,4,614,"2 : Street(1-3),Street(4-6),Street(10-12),Street(16-18),Street(22-24) | 2 : Street(31-33),Street(34-36)"
349,32,Bet,4,0,-4,-4,614,6,608,"2 : Street(10-12),Street(16-18)"
350,23,Bet,6,0,-6,-6,608,10,598,"2 : Street(10-12),Street(16-18),Street(31-33)"
351,23,Bet,10,24,-10,14,622,2,620,"2 : Street(4-6),Street(10-12),Street(16-18),Street(22-24),Street(31-33)"
352,24,Bet,2,24,-2,22,644,2,642,2 : Street(22-24)
353,17,Bet,2,0,-2,-2,642,6,636,2 : Street(22-24)
354,22,Bet,6,24,-6,18,660,6,654,"2 : Street(4-6),Street(16-18),Street(22-24)"
355,27,Bet,6,0,-6,-6,654,10,644,"2 : Street(4-6),Street(16-18),Street(22-24)"
356,7,Bet,10,48,-10,38,692,10,682,"2 : Street(1-3),Street(22-24),Street(25-27) | 4 : Street(7-9)"
357,3,Bet,10,0,-10,-10,682,14,668,"2 : Street(19-21),Street(22-24),Street(25-27) | 4 : Street(7-9)"
358,19,Bet,14,24,-14,10,692,12,680,"2 : Street(1-3),Street(19-21),Street(22-24),Street(25-27),Street(34-36) | 4 : Street(7-9)"
359,30,Bet,12,0,-12,-12,680,16,664,"2 : Street(1-3),Street(4-6),Street(7-9),Street(19-21),Street(22-24) | 2 : Street(25-27)"
360,8,Bet,16,24,-16,8,688,8,680,"2 : Street(1-3),Street(4-6),Street(7-9),Street(19-21),Street(22-24) | 2 : Street(25-27),Street(28-30),Street(34-36)"
361,25,Bet,8,0,-8,-8,680,12,668,"2 : Street(1-3),Street(4-6),Street(7-9),Street(34-36)"
362,24,Bet,12,0,-12,-12,668,16,652,"2 : Street(1-3),Street(4-6),Street(7-9),Street(19-21),Street(25-27) | 2 : Street(34-36)"
363,20,Bet,16,24,-16,8,676,10,666,"2 : Street(1-3),Street(4-6),Street(7-9),Street(19-21),Street(22-24) | 2 : Street(25-27),Street(28-30),Street(34-36)"
364,36,Bet,10,0,-10,-10,666,12,654,"2 : Street(7-9),Street(19-21),Street(22-24),Street(25-27),Street(28-30)"
365,23,Bet,12,24,-12,12,678,8,670,"2 : Street(7-9),Street(10-12),Street(19-21),Street(22-24),Street(25-27) | 2 : Street(34-36)"
366,22,Bet,8,24,-8,16,694,8,686,"2 : Street(7-9),Street(10-12),Street(19-21),Street(22-24)"
367,33,Bet,8,0,-8,-8,686,12,674,"2 : Street(7-9),Street(10-12),Street(19-21),Street(22-24)"
368,9,Bet,12,0,-12,-12,674,14,660,"2 : Street(10-12),Street(16-18),Street(22-24),Street(25-27),Street(31-33) | 2 : Street(34-36)"
369,7,Bet,14,24,-14,10,684,2,682,"2 : Street(7-9),Street(10-12),Street(16-18),Street(19-21),Street(22-24) | 2 : Street(25-27),Street(31-33)"
370,23,Bet,2,0,-2,-2,682,6,676,2 : Street(7-9)
371,7,Bet,6,24,-6,18,700,6,694,"2 : Street(7-9),Street(22-24),Street(31-33)"
372,26,Bet,6,0,-6,-6,694,8,686,"2 : Street(7-9),Street(22-24),Street(31-33)"
373,31,Bet,8,0,-8,-8,686,10,676,"2 : Street(7-9),Street(19-21),Street(22-24),Street(25-27)"
374,36,Bet,10,0,-10,-10,676,14,662,"2 : Street(7-9),Street(19-21),Street(22-24),Street(25-27),Street(31-33)"
375,2,Bet,14,0,-14,-14,662,18,644,"2 : Street(7-9),Street(19-21),Street(22-24),Street(25-27),Street(31-33) | 4 : Street(34-36)"
376,1,Bet,18,24,-18,6,668,2,666,"2 : Street(1-3),Street(7-9),Street(19-21),Street(22-24),Street(25-27) | 2 : Street(28-30),Street(31-33) | 4 : Street(34-36)"
377,33,Bet,2,0,-2,-2,666,6,660,2 : Street(1-3)
378,3,Bet,6,24,-6,18,684,6,678,"2 : Street(1-3),Street(31-33),Street(34-36)"
379,27,Bet,6,0,-6,-6,678,8,670,"2 : Street(1-3),Street(31-33),Street(34-36)"
380,14,Bet,8,0,-8,-8,670,10,660,"2 : Street(1-3),Street(25-27),Street(31-33),Street(34-36)"
381,9,Bet,10,0,-10,-10,660,12,648,"2 : Street(1-3),Street(4-6),Street(13-15),Street(25-27),Street(31-33)"
382,33,Bet,12,0,-12,-12,648,0,648,"2 : Street(1-3),Street(4-6),Street(7-9),Street(13-15),Street(25-27) | 2 : Street(34-36)"
383,20,No Bet,0,0,0,0,648,0,648,
384,11,No Bet,0,0,0,0,648,0,648,
385,16,No Bet,0,0,0,0,648,0,648,
386,33,No Bet,0,0,0,0,648,6,642,
387,21,Bet,6,24,-6,18,666,6,660,"2 : Street(19-21),Street(28-30),Street(31-33)"
388,10,Bet,6,24,-6,18,684,8,676,"2 : Street(10-12),Street(19-21),Street(31-33)"
389,7,Bet,8,0,-8,-8,676,10,666,"2 : Street(10-12),Street(16-18),Street(19-21),Street(31-33)"
390,6,Bet,10,0,-10,-10,666,12,654,"2 : Street(7-9),Street(10-12),Street(16-18),Street(19-21),Street(31-33)"
391,18,Bet,12,0,-12,-12,654,14,640,"2 : Street(4-6),Street(7-9),Street(10-12),Street(19-21),Street(28-30) | 2 : Street(31-33)"
392,25,Bet,14,0,-14,-14,640,0,640,"2 : Street(4-6),Street(7-9),Street(10-12),Street(16-18),Street(19-21) | 2 : Street(28-30),Street(31-33)"
393,34,No Bet,0,0,0,0,640,0,640,
394,16,No Bet,0,0,0,0,640,0,640,
395,22,No Bet,0,0,0,0,640,0,640,
396,29,No Bet,0,0,0,0,640,10,630,
397,23,Bet,10,48,-10,38,678,6,672,"2 : Street(1-3),Street(16-18),Street(28-30) | 4 : Street(22-24)"
398,18,Bet,6,0,-6,-6,672,8,664,"2 : Street(1-3),Street(22-24),Street(28-30)"
399,16,Bet,8,24,-8,16,688,8,680,"2 : Street(1-3),Street(16-18),Street(22-24),Street(28-30)"
400,1,Bet,8,24,-8,16,704,6,698,"2 : Street(1-3),Street(16-18),Street(22-24),Street(28-30)"
401,16,Bet,6,24,-6,18,722,6,716,"2 : Street(1-3),Street(13-15),Street(16-18)"
402,13,Bet,6,24,-6,18,740,6,734,"2 : Street(1-3),Street(13-15),Street(16-18)"
403,5,Bet,6,0,-6,-6,734,10,724,"2 : Street(13-15),Street(16-18),Street(31-33)"
404,6,Bet,10,24,-10,14,748,6,742,"2 : Street(4-6),Street(13-15),Street(16-18),Street(25-27),Street(31-33)"
405,26,Bet,6,24,-6,18,766,6,760,"2 : Street(4-6),Street(25-27),Street(31-33)"
406,29,Bet,6,0,-6,-6,760,10,750,"2 : Street(4-6),Street(25-27),Street(34-36)"
407,24,Bet,10,24,-10,14,774,10,764,"2 : Street(4-6),Street(22-24),Street(25-27),Street(28-30),Street(34-36)"
408,9,Bet,10,0,-10,-10,764,12,752,"2 : Street(1-3),Street(4-6),Street(22-24),Street(25-27),Street(28-30)"
409,19,Bet,12,0,-12,-12,752,0,752,"2 : Street(4-6),Street(7-9),Street(22-24),Street(25-27),Street(28-30) | 2 : Street(34-36)"
410,18,No Bet,0,0,0,0,752,0,752,
411,0,No Bet,0,0,0,0,752,0,752,
412,31,No Bet,0,0,0,0,752,0,752,
413,23,No Bet,0,0,0,0,752,0,752,
414,36,No Bet,0,0,0,0,752,6,746,
415,0,Bet,6,0,-6,-6,746,6,740,"2 : Street(1-3),Street(22-24),Street(34-36)"
416,6,Bet,6,0,-6,-6,740,10,730,"2 : Street(1-3),Street(22-24),Street(34-36)"
417,8,Bet,10,0,-10,-10,730,16,714,"2 : Street(1-3),Street(4-6),Street(22-24),Street(25-27),Street(34-36)"
418,21,Bet,16,24,-16,8,738,14,724,"2 : Street(1-3),Street(4-6),Street(19-21),Street(22-24),Street(25-27) | 2 : Street(34-36) | 4 : Street(7-9)"
419,15,Bet,14,0,-14,-14,724,18,706,"2 : Street(4-6),Street(19-21),Street(22-24),Street(25-27),Street(34-36) | 4 : Street(7-9)"
420,14,Bet,18,24,-18,6,730,6,724,"2 : Street(4-6),Street(13-15),Street(19-21),Street(22-24),Street(25-27) | 2 : Street(31-33),Street(34-36) | 4 : Street(7-9)"
421,27,Bet,6,24,-6,18,748,6,742,"2 : Street(13-15),Street(25-27),Street(31-33)"
422,23,Bet,6,0,-6,-6,742,10,732,"2 : Street(13-15),Street(25-27),Street(28-30)"
423,24,Bet,10,24,-10,14,756,6,750,"2 : Street(13-15),Street(22-24),Street(25-27),Street(28-30),Street(34-36)"
424,34,Bet,6,24,-6,18,774,6,768,"2 : Street(22-24),Street(28-30),Street(34-36)"
425,7,Bet,6,0,-6,-6,768,10,758,"2 : Street(4-6),Street(22-24),Street(34-36)"
426,31,Bet,10,0,-10,-10,758,14,744,"2 : Street(4-6),Street(7-9),Street(19-21),Street(22-24),Street(34-36)"
427,33,Bet,14,24,-14,10,768,8,760,"2 : Street(4-6),Street(7-9),Street(13-15),Street(19-21),Street(22-24) | 2 : Street(31-33),Street(34-36)"
428,4,Bet,8,24,-8,16,784,6,778,"2 : Street(4-6),Street(13-15),Street(19-21),Street(31-33)"
429,23,Bet,6,0,-6,-6,778,10,768,"2 : Street(4-6),Street(19-21),Street(31-33)"
430,28,Bet,10,0,-10,-10,768,14,754,"2 : Street(4-6),Street(19-21),Street(22-24),Street(31-33),Street(34-36)"
431,9,Bet,14,24,-14,10,778,10,768,"2 : Street(4-6),Street(7-9),Street(13-15),Street(16-18),Street(22-24) | 2 : Street(28-30),Street(31-33)"
432,24,Bet,10,24,-10,14,792,6,786,"2 : Street(4-6),Street(7-9),Street(22-24),Street(28-30),Street(31-33)"
433,29,Bet,6,24,-6,18,810,6,804,"2 : Street(22-24),Street(28-30),Street(31-33)"
434,29,Bet,6,24,-6,18,828,4,824,"2 : Street(7-9),Street(22-24),Street(28-30)"
435,24,Bet,4,0,-4,-4,824,6,818,"2 : Street(7-9),Street(28-30)"
436,25,Bet,6,0,-6,-6,818,8,810,"2 : Street(7-9),Street(22-24),Street(28-30)"
437,28,Bet,8,24,-8,16,834,4,830,"2 : Street(22-24),Street(25-27),Street(28-30),Street(34-36)"
438,1,Bet,4,0,-4,-4,830,6,824,"2 : Street(22-24),Street(28-30)"
439,9,Bet,6,0,-6,-6,824,8,816,"2 : Street(1-3),Street(25-27),Street(28-30)"
440,5,Bet,8,0,-8,-8,816,14,802,"2 : Street(1-3),Street(7-9),Street(22-24),Street(28-30)"
441,12,Bet,14,0,-14,-14,802,0,802,"2 : Street(1-3),Street(4-6),Street(7-9),Street(16-18),Street(22-24) | 2 : Street(25-27),Street(28-30)"
442,8,No Bet,0,0,0,0,802,4,798,
443,8,Bet,4,24,-4,20,822,4,818,"2 : Street(4-6),Street(7-9)"
444,14,Bet,4,0,-4,-4,818,8,810,"2 : Street(4-6),Street(7-9)"
445,35,Bet,8,24,-8,16,834,8,826,"2 : Street(7-9),Street(10-12),Street(13-15),Street(34-36)"
446,16,Bet,8,0,-8,-8,826,14,812,"2 : Street(7-9),Street(13-15),Street(31-33),Street(34-36)"
447,17,Bet,14,24,-14,10,836,6,830,"2 : Street(7-9),Street(13-15),Street(16-18),Street(19-21),Street(22-24) | 2 : Street(31-33),Street(34-36)"
448,4,Bet,6,0,-6,-6,830,10,820,"2 : Street(16-18),Street(19-21),Street(22-24)"
449,32,Bet,10,0,-10,-10,820,12,808,"2 : Street(4-6),Street(10-12),Street(16-18),Street(19-21),Street(22-24)"
450,30,Bet,12,0,-12,-12,808,2,806,"2 : Street(4-6),Street(7-9),Street(16-18),Street(19-21),Street(22-24) | 2 : Street(31-33)"
451,23,Bet,2,0,-2,-2,806,4,802,2 : Street(28-30)
452,34,Bet,4,0,-4,-4,802,6,796,"2 : Street(22-24),Street(28-30)"
453,1,Bet,6,0,-6,-6,796,8,788,"2 : Street(16-18),Street(22-24),Street(28-30)"
454,19,Bet,8,0,-8,-8,788,10,778,"2 : Street(4-6),Street(16-18),Street(22-24),Street(28-30)"
455,20,Bet,10,0,-10,-10,778,10,768,"2 : Street(4-6),Street(16-18),Street(22-24),Street(28-30),Street(31-33)"
456,8,Bet,10,0,-10,-10,768,6,762,"2 : Street(4-6),Street(16-18),Street(22-24),Street(28-30),Street(31-33)"
457,13,Bet,6,24,-6,18,786,4,782,"2 : Street(7-9),Street(13-15),Street(19-21)"
458,18,Bet,4,24,-4,20,806,6,800,"2 : Street(13-15),Street(16-18)"
459,6,Bet,6,24,-6,18,824,8,816,"2 : Street(4-6),Street(13-15),Street(16-18)"
460,24,Bet,8,0,-8,-8,816,14,802,"2 : Street(4-6),Street(13-15),Street(16-18),Street(31-33)"
461,1,Bet,14,0,-14,-14,802,18,784,"2 : Street(4-6),Street(13-15),Street(16-18),Street(31-33),Street(34-36) | 4 : Street(22-24)"
462,5,Bet,18,24,-18,6,808,12,796,"2 : Street(1-3),Street(4-6),Street(13-15),Street(16-18),Street(19-21) | 2 : Street(31-33),Street(34-36) | 4 : Street(22-24)"
463,24,Bet,12,48,-12,36,844,6,838,"2 : Street(4-6),Street(19-21),Street(31-33),Street(34-36) | 4 : Street(22-24)"
464,5,Bet,6,24,-6,18,862,6,856,"2 : Street(1-3),Street(4-6),Street(22-24)"
465,19,Bet,6,0,-6,-6,856,8,848,"2 : Street(1-3),Street(4-6),Street(22-24)"
466,16,Bet,8,0,-8,-8,848,10,838,"2 : Street(4-6),Street(7-9),Street(19-21),Street(22-24)"
467,11,Bet,10,0,-10,-10,838,0,838,"2 : Street(1-3),Street(4-6),Street(7-9),Street(16-18),Street(19-21)"
468,3,No Bet,0,0,0,0,838,0,838,
469,32,No Bet,0,0,0,0,838,0,838,
470,25,No Bet,0,0,0,0,838,0,838,
471,33,No Bet,0,0,0,0,838,8,830,
472,27,Bet,8,24,-8,16,854,4,850,"2 : Street(25-27),Street(28-30),Street(31-33),Street(34-36)"
473,36,Bet,4,0,-4,-4,850,8,842,"2 : Street(25-27),Street(31-33)"
474,31,Bet,8,24,-8,16,866,8,858,"2 : Street(7-9),Street(25-27),Street(31-33),Street(34-36)"
475,13,Bet,8,0,-8,-8,858,10,848,"2 : Street(7-9),Street(25-27),Street(31-33),Street(34-36)"
476,29,Bet,10,0,-10,-10,848,10,838,"2 : Street(7-9),Street(13-15),Street(16-18),Street(31-33),Street(34-36)"
477,12,Bet,10,0,-10,-10,838,0,838,"2 : Street(7-9),Street(13-15),Street(16-18),Street(28-30),Street(31-33)"
478,30,No Bet,0,0,0,0,838,4,834,
479,23,Bet,4,0,-4,-4,834,6,828,"2 : Street(10-12),Street(28-30)"
480,3,Bet,6,0,-6,-6,828,10,818,"2 : Street(10-12),Street(22-24),Street(28-30)"
481,17,Bet,10,0,-10,-10,818,0,818,"2 : Street(1-3),Street(4-6),Street(22-24),Street(25-27),Street(28-30)"
482,0,No Bet,0,0,0,0,818,0,818,
483,10,No Bet,0,0,0,0,818,0,818,
484,11,No Bet,0,0,0,0,818,12,806,
485,30,Bet,12,24,-12,12,830,6,824,"2 : Street(4-6),Street(10-12),Street(16-18),Street(19-21),Street(28-30) | 2 : Street(34-36)"
486,23,Bet,6,24,-6,18,848,6,842,"2 : Street(10-12),Street(22-24),Street(28-30)"
487,22,Bet,6,24,-6,18,866,4,862,"2 : Street(10-12),Street(22-24),Street(28-30)"
488,36,Bet,4,0,-4,-4,862,8,854,"2 : Street(1-3),Street(22-24)"
489,32,Bet,8,24,-8,16,878,8,870,"2 : Street(16-18),Street(22-24),Street(31-33),Street(34-36)"
490,25,Bet,8,0,-8,-8,870,12,858,"2 : Street(13-15),Street(22-24),Street(31-33),Street(34-36)"
491,1,Bet,12,24,-12,12,882,12,870,"2 : Street(1-3),Street(13-15),Street(22-24),Street(25-27),Street(31-33) | 2 : Street(34-36)"
492,11,Bet,12,0,-12,-12,870,16,854,"2 : Street(1-3),Street(13-15),Street(22-24),Street(25-27),Street(31-33) | 2 : Street(34-36)"
493,16,Bet,16,24,-16,8,878,16,862,"2 : Street(1-3),Street(10-12),Street(16-18),Street(22-24),Street(25-27) | 2 : Street(28-30),Street(31-33),Street(34-36)"
494,7,Bet,16,0,-16,-16,862,0,862,"2 : Street(1-3),Street(10-12),Street(16-18),Street(22-24),Street(25-27) | 2 : Street(28-30),Street(31-33),Street(34-36)"
0,,,0,0,0,0,0,4,-4,
496,14,Bet,4,0,-4,-4,858,8,850,"2 : Street(4-6),Street(7-9)"
497,33,Bet,8,0,-8,-8,850,12,838,"2 : Street(1-3),Street(7-9),Street(10-12),Street(13-15)"
498,24,Bet,12,0,-12,-12,838,14,824,"2 : Street(4-6),Street(13-15),Street(28-30),Street(31-33) | 4 : Street(7-9)"
499,17,Bet,14,0,-14,-14,824,16,808,"2 : Street(1-3),Street(7-9),Street(13-15),Street(19-21),Street(22-24) | 2 : Street(28-30),Street(31-33)"
500,11,Bet,16,24,-16,8,832,14,818,"2 : Street(7-9),Street(10-12),Street(13-15),Street(16-18),Street(19-21) | 2 : Street(22-24),Street(28-30),Street(31-33)"
501,16,Bet,14,24,-14,10,842,6,836,"2 : Street(4-6),Street(7-9),Street(10-12),Street(13-15),Street(16-18) | 2 : Street(22-24),Street(31-33)"
502,22,Bet,6,0,-6,-6,836,8,828,"2 : Street(4-6),Street(10-12),Street(16-18)"
503,21,Bet,8,0,-8,-8,828,10,818,"2 : Street(4-6),Street(10-12),Street(16-18),Street(22-24)"
504,7,Bet,10,0,-10,-10,818,14,804,"2 : Street(1-3),Street(4-6),Street(16-18),Street(19-21),Street(22-24)"
505,25,Bet,14,0,-14,-14,804,18,786,"2 : Street(1-3),Street(4-6),Street(7-9),Street(13-15),Street(16-18) | 2 : Street(19-21),Street(22-24)"
506,28,Bet,18,0,-18,-18,786,22,764,"2 : Street(1-3),Street(4-6),Street(7-9),Street(13-15),Street(16-18) | 2 : Street(19-21),Street(22-24),Street(25-27),Street(31-33)"
507,7,Bet,22,24,-22,2,788,4,784,"2 : Street(1-3),Street(4-6),Street(7-9),Street(10-12),Street(13-15) | 2 : Street(16-18),Street(19-21),Street(22-24),Street(25-27),Street(28-30) | 2 : Street(31-33)"
508,19,Bet,4,0,-4,-4,784,8,776,"2 : Street(7-9),Street(25-27)"
509,28,Bet,8,24,-8,16,800,6,794,"2 : Street(7-9),Street(19-21),Street(25-27),Street(28-30)"
510,15,Bet,6,0,-6,-6,794,10,784,"2 : Street(7-9),Street(19-21),Street(28-30)"
511,3,Bet,10,0,-10,-10,784,14,770,"2 : Street(7-9),Street(13-15),Street(19-21),Street(28-30),Street(31-33)"
512,30,Bet,14,24,-14,10,794,4,790,"2 : Street(1-3),Street(7-9),Street(10-12),Street(13-15),Street(19-21) | 2 : Street(28-30),Street(31-33)"
513,20,Bet,4,0,-4,-4,790,8,782,"2 : Street(13-15),Street(28-30)"
514,17,Bet,8,0,-8,-8,782,10,772,"2 : Street(1-3),Street(13-15),Street(19-21),Street(28-30)"
515,8,Bet,10,0,-10,-10,772,12,760,"2 : Street(1-3),Street(16-18),Street(19-21),Street(22-24),Street(28-30)"
516,4,Bet,12,0,-12,-12,760,16,744,"2 : Street(7-9),Street(13-15),Street(16-18),Street(19-21),Street(22-24) | 2 : Street(28-30)"
517,13,Bet,16,0,-16,-16,744,18,726,"2 : Street(1-3),Street(4-6),Street(7-9),Street(16-18),Street(19-21) | 2 : Street(25-27),Street(28-30),Street(31-33)"
518,34,Bet,18,0,-18,-18,726,20,706,"2 : Street(1-3),Street(4-6),Street(7-9),Street(13-15),Street(16-18) | 2 : Street(19-21),Street(25-27),Street(28-30),Street(31-33)"
519,9,Bet,20,24,-20,4,730,4,726,"2 : Street(1-3),Street(4-6),Street(7-9),Street(10-12),Street(13-15) | 2 : Street(16-18),Street(19-21),Street(28-30),Street(31-33),Street(34-36)"
520,21,Bet,4,0,-4,-4,726,8,718,"2 : Street(4-6),Street(7-9)"
521,28,Bet,8,0,-8,-8,718,12,706,"2 : Street(7-9),Street(13-15),Street(16-18),Street(19-21)"
522,14,Bet,12,0,-12,-12,706,14,692,"2 : Street(4-6),Street(7-9),Street(16-18),Street(19-21),Street(28-30) | 2 : Street(34-36)"
523,21,Bet,14,24,-14,10,716,12,704,"2 : Street(4-6),Street(7-9),Street(13-15),Street(16-18),Street(19-21) | 2 : Street(28-30),Street(34-36)"
524,18,Bet,12,24,-12,12,728,6,722,"2 : Street(4-6),Street(7-9),Street(16-18),Street(19-21),Street(28-30) | 2 : Street(34-36)"
525,26,Bet,6,0,-6,-6,722,10,712,"2 : Street(4-6),Street(16-18),Street(19-21)"
526,9,Bet,10,0,-10,-10,712,12,700,"2 : Street(1-3),Street(16-18),Street(19-21),Street(25-27),Street(34-36)"
527,9,Bet,12,24,-12,12,724,8,716,"2 : Street(1-3),Street(7-9),Street(16-18),Street(19-21),Street(25-27) | 2 : Street(34-36)"
528,2,Bet,8,24,-8,16,740,6,734,"2 : Street(1-3),Street(7-9),Street(25-27),Street(34-36)"
529,36,Bet,6,0,-6,-6,734,10,724,"2 : Street(1-3),Street(4-6),Street(7-9)"
530,19,Bet,10,0,-10,-10,724,14,710,"2 : Street(1-3),Street(4-6),Street(7-9),Street(28-30),Street(34-36)"
531,9,Bet,14,24,-14,10,734,10,724,"2 : Street(1-3),Street(4-6),Street(7-9),Street(16-18),Street(19-21) | 2 : Street(28-30),Street(34-36)"
532,33,Bet,10,0,-10,-10,724,14,710,"2 : Street(1-3),Street(4-6),Street(7-9),Street(16-18),Street(28-30)"
533,1,Bet,14,0,-14,-14,710,18,692,"2 : Street(7-9),Street(10-12),Street(13-15),Street(25-27),Street(28-30) | 2 : Street(31-33),Street(34-36)"
534,22,Bet,18,0,-18,-18,692,20,672,"2 : Street(1-3),Street(7-9),Street(10-12),Street(13-15),Street(19-21) | 2 : Street(25-27),Street(28-30),Street(31-33),Street(34-36)"
535,18,Bet,20,24,-20,4,696,12,684,"2 : Street(1-3),Street(4-6),Street(7-9),Street(10-12),Street(13-15) | 2 : Street(16-18),Street(19-21),Street(22-24),Street(31-33),Street(34-36)"
536,23,Bet,12,24,-12,12,708,6,702,"2 : Street(1-3),Street(7-9),Street(16-18),Street(22-24),Street(25-27) | 2 : Street(31-33)"
537,16,Bet,6,24,-6,18,726,4,722,"2 : Street(16-18),Street(22-24),Street(25-27)"
538,35,Bet,4,0,-4,-4,722,8,714,"2 : Street(16-18),Street(22-24)"
539,17,Bet,8,24,-8,16,738,4,734,"2 : Street(16-18),Street(19-21),Street(22-24),Street(34-36)"
540,10,Bet,4,0,-4,-4,734,6,728,"2 : Street(16-18),Street(34-36)"
541,31,Bet,6,0,-6,-6,728,10,718,"2 : Street(4-6),Street(10-12),Street(16-18)"
542,19,Bet,10,0,-10,-10,718,14,704,"2 : Street(1-3),Street(4-6),Street(10-12),Street(16-18),Street(31-33)"
543,22,Bet,14,24,-14,10,728,12,716,"2 : Street(4-6),Street(7-9),Street(10-12),Street(16-18),Street(19-21) | 2 : Street(22-24),Street(31-33)"
544,35,Bet,12,24,-12,12,740,12,728,"2 : Street(10-12),Street(16-18),Street(19-21),Street(22-24),Street(31-33) | 2 : Street(34-36)"
545,19,Bet,12,24,-12,12,752,6,746,"2 : Street(10-12),Street(16-18),Street(19-21),Street(22-24),Street(31-33) | 2 : Street(34-36)"
546,30,Bet,6,0,-6,-6,746,10,736,"2 : Street(16-18),Street(19-21),Street(22-24)"
547,8,Bet,10,0,-10,-10,736,12,724,"2 : Street(10-12),Street(13-15),Street(19-21),Street(28-30),Street(34-36)"
548,5,Bet,12,0,-12,-12,724,16,708,"2 : Street(1-3),Street(7-9),Street(13-15),Street(19-21),Street(28-30) | 2 : Street(31-33)"
0,,,0,0,0,0,0,8,-8,
550,34,Bet,8,0,-8,-8,724,12,712,"2 : Street(4-6),Street(7-9),Street(25-27),Street(28-30)"
551,6,Bet,12,24,-12,12,736,4,732,"2 : Street(4-6),Street(7-9),Street(22-24),Street(28-30),Street(31-33) | 2 : Street(34-36)"
552,16,Bet,4,0,-4,-4,732,8,724,"2 : Street(4-6),Street(28-30)"
553,24,Bet,8,0,-8,-8,724,8,716,"2 : Street(4-6),Street(13-15),Street(16-18),Street(34-36)"
554,36,Bet,8,0,-8,-8,716,12,704,"2 : Street(4-6),Street(10-12),Street(19-21),Street(22-24)"
555,11,Bet,12,24,-12,12,728,8,720,"2 : Street(4-6),Street(10-12),Street(16-18),Street(19-21),Street(22-24) | 2 : Street(34-36)"
556,31,Bet,8,0,-8,-8,720,12,708,"2 : Street(1-3),Street(10-12),Street(22-24),Street(34-36)"
557,10,Bet,12,24,-12,12,732,8,724,"2 : Street(7-9),Street(10-12),Street(22-24),Street(25-27),Street(31-33) | 2 : Street(34-36)"
558,30,Bet,8,0,-8,-8,724,10,714,"2 : Street(7-9),Street(10-12),Street(25-27),Street(31-33)"
559,12,Bet,10,24,-10,14,738,4,734,"2 : Street(4-6),Street(7-9),Street(10-12),Street(25-27),Street(28-30)"
560,1,Bet,4,0,-4,-4,734,6,728,"2 : Street(10-12),Street(28-30)"
561,18,Bet,6,0,-6,-6,728,10,718,"2 : Street(1-3),Street(7-9),Street(10-12)"
562,10,Bet,10,24,-10,14,742,8,734,"2 : Street(1-3),Street(7-9),Street(10-12),Street(16-18),Street(22-24)"
563,3,Bet,8,0,-8,-8,734,10,724,"2 : Street(7-9),Street(10-12),Street(13-15),Street(16-18)"
564,0,Bet,10,0,-10,-10,724,10,714,"2 : Street(1-3),Street(7-9),Street(10-12),Street(13-15),Street(16-18)"
565,5,Bet,10,0,-10,-10,714,12,702,"2 : Street(1-3),Street(7-9),Street(10-12),Street(13-15),Street(16-18)"
566,36,Bet,12,0,-12,-12,702,14,688,"2 : Street(1-3),Street(4-6),Street(7-9),Street(10-12),Street(13-15) | 2 : Street(16-18)"
567,12,Bet,14,24,-14,10,712,4,708,"2 : Street(1-3),Street(4-6),Street(7-9),Street(10-12),Street(16-18) | 2 : Street(31-33),Street(34-36)"
568,3,Bet,4,24,-4,20,732,6,726,"2 : Street(1-3),Street(10-12)"
569,0,Bet,6,0,-6,-6,726,6,720,"2 : Street(1-3),Street(4-6),Street(10-12)"
570,22,Bet,6,0,-6,-6,720,10,710,"2 : Street(1-3),Street(4-6),Street(10-12)"
571,29,Bet,10,0,-10,-10,710,12,698,"2 : Street(1-3),Street(10-12),Street(19-21),Street(22-24),Street(34-36)"
572,24,Bet,12,24,-12,12,722,12,710,"2 : Street(1-3),Street(10-12),Street(13-15),Street(22-24),Street(25-27) | 2 : Street(28-30)"
573,0,Bet,12,0,-12,-12,710,12,698,"2 : Street(1-3),Street(10-12),Street(13-15),Street(22-24),Street(25-27) | 2 : Street(28-30)"
574,3,Bet,12,24,-12,12,722,14,708,"2 : Street(1-3),Street(10-12),Street(13-15),Street(22-24),Street(25-27) | 2 : Street(28-30)"
575,10,Bet,14,24,-14,10,732,8,724,"2 : Street(10-12),Street(13-15),Street(22-24),Street(25-27),Street(28-30) | 4 : Street(1-3)"
576,15,Bet,8,0,-8,-8,724,10,714,"2 : Street(1-3),Street(10-12),Street(22-24),Street(28-30)"
577,17,Bet,10,0,-10,-10,714,14,700,"2 : Street(1-3),Street(7-9),Street(10-12),Street(13-15),Street(22-24)"
578,29,Bet,14,0,-14,-14,700,16,684,"2 : Street(1-3),Street(4-6),Street(7-9),Street(10-12),Street(13-15) | 2 : Street(16-18),Street(22-24)"
579,16,Bet,16,24,-16,8,708,12,696,"2 : Street(1-3),Street(4-6),Street(7-9),Street(10-12),Street(13-15) | 2 : Street(16-18),Street(22-24),Street(28-30)"
580,3,Bet,12,0,-12,-12,696,14,682,"2 : Street(4-6),Street(7-9),Street(10-12),Street(16-18),Street(22-24) | 2 : Street(28-30)"
581,14,Bet,14,24,-14,10,706,8,698,"2 : Street(1-3),Street(4-6),Street(7-9),Street(10-12),Street(13-15) | 2 : Street(16-18),Street(22-24)"
582,7,Bet,8,0,-8,-8,698,10,688,"2 : Street(1-3),Street(13-15),Street(16-18),Street(28-30)"
583,13,Bet,10,24,-10,14,712,8,704,"2 : Street(1-3),Street(4-6),Street(13-15),Street(16-18) | 2 : Line(7-12)"
584,32,Bet,8,0,-8,-8,704,10,694,"2 : Street(4-6),Street(7-9),Street(13-15),Street(16-18)"
585,11,Bet,10,0,-10,-10,694,14,680,"2 : Street(1-3),Street(13-15),Street(25-27),Street(31-33),Street(34-36)"
586,2,Bet,14,0,-14,-14,680,16,664,"2 : Street(7-9),Street(10-12),Street(13-15),Street(25-27),Street(28-30) | 2 : Street(31-33),Street(34-36)"
587,30,Bet,16,24,-16,8,688,12,676,"2 : Street(1-3),Street(7-9),Street(10-12),Street(13-15),Street(25-27) | 2 : Street(28-30),Street(31-33),Street(34-36)"
588,1,Bet,12,24,-12,12,700,6,694,"2 : Street(1-3),Street(10-12),Street(13-15),Street(16-18),Street(28-30) | 2 : Street(31-33)"
589,18,Bet,6,24,-6,18,718,6,712,"2 : Street(1-3),Street(16-18),Street(28-30)"
590,19,Bet,6,0,-6,-6,712,10,702,"2 : Street(1-3),Street(7-9),Street(16-18)"
591,14,Bet,10,24,-10,14,726,10,716,"2 : Street(1-3),Street(4-6),Street(13-15),Street(16-18),Street(19-21)"
592,28,Bet,10,0,-10,-10,716,12,704,"2 : Street(1-3),Street(13-15),Street(16-18),Street(19-21),Street(31-33)"
593,11,Bet,12,0,-12,-12,704,14,690,"2 : Street(1-3),Street(13-15),Street(16-18),Street(19-21),Street(28-30) | 2 : Street(31-33)"
594,26,Bet,14,0,-14,-14,690,16,674,"2 : Street(1-3),Street(10-12),Street(13-15),Street(16-18),Street(19-21) | 2 : Street(28-30),Street(31-33)"
595,12,Bet,16,24,-16,8,698,12,686,"2 : Street(1-3),Street(4-6),Street(10-12),Street(13-15),Street(16-18) | 2 : Street(19-21),Street(25-27),Street(28-30)"
596,5,Bet,12,24,-12,12,710,6,704,"2 : Street(1-3),Street(4-6),Street(10-12),Street(16-18),Street(19-21) | 2 : Street(25-27)"
597,12,Bet,6,24,-6,18,728,6,722,"2 : Street(4-6),Street(10-12),Street(34-36)"
598,8,Bet,6,0,-6,-6,722,10,712,"2 : Street(4-6),Street(10-12),Street(34-36)"
599,8,Bet,10,48,-10,38,760,10,750,"2 : Street(10-12),Street(31-33),Street(34-36) | 4 : Street(7-9)"
600,35,Bet,10,24,-10,14,774,6,768,"2 : Street(10-12),Street(31-33),Street(34-36) | 4 : Street(7-9)"
601,31,Bet,6,0,-6,-6,768,4,764,"2 : Street(7-9),Street(22-24),Street(34-36)"
602,24,Bet,4,24,-4,20,788,6,782,"2 : Street(22-24),Street(34-36)"
603,9,Bet,6,0,-6,-6,782,8,774,"2 : Street(22-24),Street(31-33),Street(34-36)"
604,5,Bet,8,0,-8,-8,774,8,766,"2 : Street(7-9),Street(10-12),Street(19-21),Street(22-24)"
605,19,Bet,8,0,-8,-8,766,10,756,"2 : Street(1-3),Street(4-6),Street(7-9),Street(22-24)"
606,1,Bet,10,0,-10,-10,756,12,744,"2 : Street(4-6),Street(7-9),Street(16-18),Street(19-21),Street(22-24)"
607,16,Bet,12,24,-12,12,768,14,754,"2 : Street(1-3),Street(4-6),Street(7-9),Street(16-18),Street(19-21) | 2 : Street(22-24)"
608,15,Bet,14,24,-14,10,778,16,762,"2 : Street(1-3),Street(4-6),Street(7-9),Street(13-15),Street(16-18) | 2 : Street(19-21),Street(22-24)"
609,32,Bet,16,0,-16,-16,762,18,744,"2 : Street(1-3),Street(4-6),Street(7-9),Street(10-12),Street(13-15) | 2 : Street(16-18),Street(19-21),Street(22-24)"
610,13,Bet,18,24,-18,6,768,8,760,"2 : Street(1-3),Street(4-6),Street(7-9),Street(13-15),Street(16-18) | 2 : Street(19-21),Street(22-24),Street(28-30),Street(31-33)"
611,22,Bet,8,24,-8,16,784,6,778,"2 : Street(13-15),Street(22-24),Street(28-30),Street(31-33)"
612,27,Bet,6,0,-6,-6,778,10,768,"2 : Street(7-9),Street(13-15),Street(22-24)"
613,16,Bet,10,0,-10,-10,768,14,754,"2 : Street(4-6),Street(10-12),Street(13-15),Street(22-24),Street(25-27)"
614,15,Bet,14,24,-14,10,778,10,768,"2 : Street(4-6),Street(10-12),Street(13-15),Street(16-18),Street(22-24) | 2 : Street(25-27),Street(31-33)"
615,14,Bet,10,24,-10,14,792,10,782,"2 : Street(4-6),Street(10-12),Street(13-15),Street(22-24),Street(31-33)"
616,9,Bet,10,0,-10,-10,782,14,768,"2 : Street(4-6),Street(10-12),Street(13-15),Street(22-24),Street(31-33)"
617,9,Bet,14,24,-14,10,792,2,790,"2 : Street(4-6),Street(7-9),Street(10-12),Street(13-15),Street(19-21) | 2 : Street(22-24),Street(25-27)"
618,19,Bet,2,0,-2,-2,790,8,782,2 : Street(7-9)
619,4,Bet,8,0,-8,-8,782,10,772,"2 : Street(1-3),Street(7-9),Street(16-18),Street(19-21)"
620,7,Bet,10,24,-10,14,796,4,792,"2 : Street(1-3),Street(4-6),Street(7-9),Street(16-18),Street(19-21)"
621,2,Bet,4,0,-4,-4,792,8,784,"2 : Street(7-9),Street(19-21)"
622,24,Bet,8,0,-8,-8,784,10,774,"2 : Street(1-3),Street(4-6),Street(7-9),Street(19-21)"
623,1,Bet,10,24,-10,14,798,10,788,"2 : Street(1-3),Street(4-6),Street(7-9),Street(16-18),Street(22-24)"
624,14,Bet,10,0,-10,-10,788,12,776,"2 : Street(1-3),Street(4-6),Street(7-9),Street(16-18),Street(22-24)"
625,22,Bet,12,24,-12,12,800,6,794,"2 : Street(1-3),Street(7-9),Street(10-12),Street(13-15),Street(16-18) | 2 : Street(22-24)"
626,10,Bet,6,0,-6,-6,794,10,784,"2 : Street(1-3),Street(13-15),Street(22-24)"
627,7,Bet,10,0,-10,-10,784,12,772,"2 : Street(1-3),Street(10-12),Street(13-15),Street(19-21),Street(22-24)"
628,22,Bet,12,24,-12,12,796,4,792,"2 : Street(1-3),Street(7-9),Street(10-12),Street(13-15),Street(19-21) | 2 : Street(22-24)"
629,33,Bet,4,0,-4,-4,792,8,784,"2 : Street(10-12),Street(22-24)"
630,32,Bet,8,24,-8,16,808,6,802,"2 : Street(10-12),Street(22-24),Street(28-30),Street(31-33)"
631,9,Bet,6,0,-6,-6,802,10,792,"2 : Street(10-12),Street(28-30),Street(31-33)"
632,22,Bet,10,24,-10,14,816,10,806,"2 : Street(1-3),Street(4-6),Street(22-24),Street(28-30),Street(31-33)"
633,34,Bet,10,0,-10,-10,806,8,798,"2 : Street(1-3),Street(19-21),Street(22-24) | 4 : Street(7-9)"
634,5,Bet,8,0,-8,-8,798,14,784,"2 : Street(7-9),Street(22-24),Street(31-33),Street(34-36)"
635,22,Bet,14,24,-14,10,808,4,804,"2 : Street(1-3),Street(4-6),Street(7-9),Street(16-18),Street(22-24) | 2 : Street(31-33),Street(34-36)"
636,17,Bet,4,0,-4,-4,804,8,796,"2 : Street(22-24),Street(34-36)"
637,19,Bet,8,0,-8,-8,796,4,792,"2 : Street(4-6),Street(13-15),Street(16-18),Street(22-24)"
638,15,Bet,4,24,-4,20,816,2,814,"2 : Street(10-12),Street(13-15)"
639,17,Bet,2,0,-2,-2,814,4,810,2 : Street(13-15)
640,13,Bet,4,24,-4,20,834,4,830,"2 : Street(13-15),Street(16-18)"
641,8,Bet,4,0,-4,-4,830,6,824,"2 : Street(13-15),Street(16-18)"
642,31,Bet,6,0,-6,-6,824,10,814,"2 : Street(7-9),Street(13-15),Street(34-36)"
643,34,Bet,10,0,-10,-10,814,16,798,"2 : Street(4-6),Street(7-9),Street(13-15),Street(28-30),Street(31-33)"
644,20,Bet,16,0,-16,-16,798,18,780,"2 : Street(4-6),Street(7-9),Street(13-15),Street(28-30),Street(31-33) | 2 : Street(34-36) | 4 : Street(22-24)"
645,33,Bet,18,24,-18,6,804,8,796,"2 : Street(7-9),Street(10-12),Street(13-15),Street(16-18),Street(19-21) | 2 : Street(22-24),Street(28-30),Street(31-33),Street(34-36)"
646,9,Bet,8,0,-8,-8,796,14,782,"2 : Street(13-15),Street(19-21),Street(28-30),Street(31-33)"
647,26,Bet,14,0,-14,-14,782,16,766,"2 : Street(4-6),Street(13-15),Street(19-21),Street(28-30),Street(31-33) | 4 : Street(7-9)"
648,4,Bet,16,0,-16,-16,766,18,748,"2 : Street(1-3),Street(7-9),Street(10-12),Street(19-21),Street(22-24) | 2 : Street(25-27),Street(28-30),Street(31-33)"
649,9,Bet,18,24,-18,6,772,14,758,"2 : Street(1-3),Street(4-6),Street(7-9),Street(10-12),Street(19-21) | 2 : Street(22-24),Street(25-27),Street(28-30),Street(31-33)"
650,3,Bet,14,24,-14,10,782,6,776,"2 : Street(1-3),Street(7-9),Street(10-12),Street(19-21),Street(22-24) | 2 : Street(25-27),Street(28-30)"
651,32,Bet,6,0,-6,-6,776,10,766,"2 : Street(1-3),Street(7-9),Street(19-21)"
652,8,Bet,10,24,-10,14,790,8,782,"2 : Street(1-3),Street(7-9),Street(19-21),Street(25-27),Street(31-33)"
653,7,Bet,8,24,-8,16,806,8,798,"2 : Street(1-3),Street(7-9),Street(19-21),Street(25-27)"
654,17,Bet,8,0,-8,-8,798,12,786,"2 : Street(1-3),Street(7-9),Street(19-21),Street(25-27)"
655,5,Bet,12,24,-12,12,810,8,802,"2 : Street(4-6),Street(7-9),Street(13-15),Street(16-18),Street(25-27) | 2 : Street(31-33)"
656,0,Bet,8,0,-8,-8,802,8,794,"2 : Street(1-3),Street(4-6),Street(7-9),Street(16-18)"
657,32,Bet,8,0,-8,-8,794,10,784,"2 : Street(1-3),Street(4-6),Street(7-9),Street(16-18)"
658,35,Bet,10,0,-10,-10,784,12,772,"2 : Street(1-3),Street(4-6),Street(7-9),Street(16-18),Street(31-33)"
659,9,Bet,12,24,-12,12,796,4,792,"2 : Street(4-6),Street(7-9),Street(16-18),Street(28-30),Street(31-33) | 2 : Street(34-36)"
660,7,Bet,4,24,-4,20,816,4,812,"2 : Street(7-9),Street(16-18)"
661,14,Bet,4,0,-4,-4,812,8,804,"2 : Street(7-9),Street(16-18)"
662,22,Bet,8,0,-8,-8,804,12,792,"2 : Street(4-6),Street(7-9),Street(10-12),Street(13-15)"
663,19,Bet,12,24,-12,12,816,10,806,"2 : Street(7-9),Street(10-12),Street(13-15),Street(19-21),Street(22-24) | 2 : Street(31-33)"
664,15,Bet,10,24,-10,14,830,6,824,"2 : Street(7-9),Street(13-15),Street(19-21),Street(22-24),Street(25-27)"
665,20,Bet,6,0,-6,-6,824,8,816,"2 : Street(13-15),Street(22-24),Street(25-27)"
666,4,Bet,8,0,-8,-8,816,10,806,"2 : Street(13-15),Street(19-21),Street(22-24),Street(25-27)"
667,12,Bet,10,0,-10,-10,806,14,792,"2 : Street(4-6),Street(13-15),Street(19-21),Street(25-27),Street(31-33)"
668,36,Bet,14,24,-14,10,816,12,804,"2 : Street(1-3),Street(4-6),Street(10-12),Street(13-15),Street(19-21) | 2 : Street(25-27),Street(34-36)"
669,8,Bet,12,24,-12,12,828,14,814,"2 : Street(4-6),Street(7-9),Street(10-12),Street(13-15),Street(19-21) | 2 : Street(34-36)"
670,7,Bet,14,24,-14,10,838,4,834,"2 : Street(4-6),Street(7-9),Street(10-12),Street(13-15),Street(19-21) | 2 : Street(22-24),Street(34-36)"
671,6,Bet,4,0,-4,-4,834,8,826,"2 : Street(7-9),Street(22-24)"
672,2,Bet,8,0,-8,-8,826,12,814,"2 : Street(4-6),Street(7-9),Street(10-12),Street(22-24)"
673,6,Bet,12,24,-12,12,838,10,828,"2 : Street(1-3),Street(4-6),Street(7-9),Street(13-15),Street(16-18) | 2 : Street(34-36)"
674,11,Bet,10,0,-10,-10,828,12,816,"2 : Street(1-3),Street(4-6),Street(13-15),Street(16-18),Street(34-36)"
675,15,Bet,12,24,-12,12,840,8,832,"2 : Street(4-6),Street(7-9),Street(10-12),Street(13-15),Street(16-18) | 2 : Street(34-36)"
676,35,Bet,8,0,-8,-8,832,12,820,"2 : Street(4-6),Street(10-12),Street(13-15),Street(19-21)"
677,32,Bet,12,0,-12,-12,820,16,804,"2 : Street(4-6),Street(7-9),Street(10-12),Street(13-15),Street(19-21) | 2 : Street(34-36)"
678,5,Bet,16,24,-16,8,828,10,818,"2 : Street(1-3),Street(4-6),Street(7-9),Street(10-12),Street(13-15) | 2 : Street(22-24),Street(31-33),Street(34-36)"
679,34,Bet,10,0,-10,-10,818,12,806,"2 : Street(1-3),Street(28-30),Street(31-33) | 4 : Street(4-6)"
680,21,Bet,12,0,-12,-12,806,14,792,"2 : Street(25-27),Street(28-30),Street(31-33),Street(34-36) | 4 : Street(4-6)"
681,9,Bet,14,0,-14,-14,792,18,774,"2 : Street(4-6),Street(16-18),Street(19-21),Street(25-27),Street(28-30) | 2 : Street(31-33),Street(34-36)"
682,30,Bet,18,24,-18,6,798,14,784,"2 : Street(1-3),Street(4-6),Street(7-9),Street(16-18),Street(19-21) | 2 : Street(25-27),Street(28-30),Street(31-33),Street(34-36)"
683,28,Bet,14,24,-14,10,808,2,806,"2 : Street(4-6),Street(7-9),Street(19-21),Street(25-27),Street(28-30) | 2 : Street(31-33),Street(34-36)"
684,22,Bet,2,0,-2,-2,806,6,800,2 : Street(28-30)
685,2,Bet,6,0,-6,-6,800,10,790,"2 : Street(16-18),Street(22-24),Street(28-30)"
686,16,Bet,10,24,-10,14,814,10,804,"2 : Street(1-3),Street(16-18),Street(22-24),Street(28-30),Street(31-33)"
687,3,Bet,10,24,-10,14,828,6,822,"2 : Street(1-3),Street(13-15),Street(16-18),Street(22-24),Street(28-30)"
688,36,Bet,6,0,-6,-6,822,8,814,"2 : Street(1-3),Street(13-15),Street(16-18)"
689,15,Bet,8,24,-8,16,838,8,830,"2 : Street(1-3),Street(13-15),Street(19-21),Street(34-36)"
690,35,Bet,8,24,-8,16,854,6,848,"2 : Street(1-3),Street(10-12),Street(13-15),Street(34-36)"
691,28,Bet,6,0,-6,-6,848,8,840,"2 : Street(10-12),Street(13-15),Street(34-36)"
692,29,Bet,8,24,-8,16,864,8,856,"2 : Street(10-12),Street(22-24),Street(28-30),Street(34-36)"
693,16,Bet,8,0,-8,-8,856,10,846,"2 : Street(10-12),Street(22-24),Street(28-30),Street(34-36)"
694,3,Bet,10,24,-10,14,870,8,862,"2 : Street(1-3),Street(10-12),Street(16-18),Street(22-24),Street(28-30)"
695,31,Bet,8,0,-8,-8,862,12,850,"2 : Street(1-3),Street(13-15),Street(16-18),Street(28-30)"
696,36,Bet,12,24,-12,12,874,10,864,"2 : Street(1-3),Street(4-6),Street(16-18),Street(28-30),Street(31-33) | 2 : Street(34-36)"
697,30,Bet,10,24,-10,14,888,4,884,"2 : Street(1-3),Street(16-18),Street(28-30),Street(31-33),Street(34-36)"
698,27,Bet,4,0,-4,-4,884,8,876,"2 : Street(16-18),Street(28-30)"
699,16,Bet,8,0,-8,-8,876,12,864,"2 : Street(1-3),Street(10-12),Street(25-27),Street(28-30)"
700,12,Bet,12,24,-12,12,888,8,880,"2 : Street(1-3),Street(10-12),Street(16-18),Street(25-27),Street(28-30) | 2 : Street(31-33)"
701,15,Bet,8,24,-8,16,904,8,896,"2 : Street(7-9),Street(10-12),Street(13-15),Street(16-18)"
702,25,Bet,8,0,-8,-8,896,12,884,"2 : Street(7-9),Street(10-12),Street(13-15),Street(16-18)"
703,11,Bet,12,24,-12,12,908,8,900,"2 : Street(4-6),Street(10-12),Street(13-15),Street(16-18),Street(22-24) | 2 : Street(25-27)"
704,4,Bet,8,24,-8,16,924,6,918,"2 : Street(4-6),Street(10-12),Street(13-15),Street(22-24)"
705,15,Bet,6,0,-6,-6,918,10,908,"2 : Street(1-3),Street(4-6),Street(10-12)"
706,26,Bet,10,24,-10,14,932,8,924,"2 : Street(1-3),Street(4-6),Street(10-12),Street(13-15),Street(25-27)"
707,18,Bet,8,0,-8,-8,924,10,914,"2 : Street(4-6),Street(10-12),Street(13-15),Street(25-27)"
708,26,Bet,10,24,-10,14,938,8,930,"2 : Street(4-6),Street(10-12),Street(13-15),Street(16-18),Street(25-27)"
709,22,Bet,8,0,-8,-8,930,10,920,"2 : Street(4-6),Street(10-12),Street(16-18),Street(25-27)"
710,26,Bet,10,24,-10,14,944,4,940,"2 : Street(4-6),Street(10-12),Street(19-21),Street(22-24),Street(25-27)"
711,36,Bet,4,0,-4,-4,940,14,926,"2 : Street(22-24),Street(25-27)"
712,33,Bet,14,24,-14,10,950,10,940,"2 : Street(7-9),Street(13-15),Street(16-18),Street(22-24),Street(25-27) | 2 : Street(31-33),Street(34-36)"
713,23,Bet,10,24,-10,14,964,6,958,"2 : Street(22-24),Street(25-27),Street(28-30),Street(31-33),Street(34-36)"
714,0,Bet,6,0,-6,-6,958,6,952,"2 : Street(22-24),Street(28-30),Street(34-36)"
715,5,Bet,6,0,-6,-6,952,10,942,"2 : Street(22-24),Street(28-30),Street(34-36)"
716,22,Bet,10,24,-10,14,966,10,956,"2 : Street(4-6),Street(13-15),Street(22-24),Street(28-30),Street(31-33)"
717,27,Bet,10,0,-10,-10,956,12,944,"2 : Street(4-6),Street(13-15),Street(22-24),Street(28-30),Street(31-33)"
718,1,Bet,12,0,-12,-12,944,12,932,"2 : Street(4-6),Street(13-15),Street(22-24),Street(25-27),Street(28-30) | 2 : Street(34-36)"
719,28,Bet,12,24,-12,12,956,6,950,"2 : Street(1-3),Street(10-12),Street(22-24),Street(25-27),Street(28-30) | 2 : Street(31-33)"
720,36,Bet,6,0,-6,-6,950,10,940,"2 : Street(1-3),Street(25-27),Street(28-30)"
721,7,Bet,10,0,-10,-10,940,14,926,"2 : Street(1-3),Street(22-24),Street(28-30),Street(31-33),Street(34-36)"
722,13,Bet,14,0,-14,-14,926,16,910,"2 : Street(1-3),Street(4-6),Street(7-9),Street(22-24),Street(28-30) | 2 : Street(31-33),Street(34-36)"
723,23,Bet,16,24,-16,8,934,14,920,"2 : Street(1-3),Street(7-9),Street(10-12),Street(13-15),Street(22-24) | 2 : Street(28-30),Street(31-33),Street(34-36)"
724,33,Bet,14,0,-14,-14,920,18,902,"2 : Street(1-3),Street(7-9),Street(13-15),Street(19-21),Street(22-24) | 2 : Street(28-30),Street(34-36)"
725,12,Bet,18,0,-18,-18,902,22,880,"2 : Street(1-3),Street(7-9),Street(13-15),Street(16-18),Street(22-24) | 2 : Street(25-27),Street(28-30),Street(31-33),Street(34-36)"
726,25,Bet,22,24,-22,2,904,20,884,"2 : Street(1-3),Street(4-6),Street(7-9),Street(10-12),Street(13-15) | 2 : Street(16-18),Street(22-24),Street(25-27),Street(28-30),Street(31-33) | 2 : Street(34-36)"
727,8,Bet,20,24,-20,4,908,6,902,"2 : Street(1-3),Street(7-9),Street(10-12),Street(13-15),Street(19-21) | 2 : Street(22-24),Street(25-27),Street(28-30),Street(31-33),Street(34-36)"
728,24,Bet,6,0,-6,-6,902,10,892,"2 : Street(7-9),Street(13-15),Street(19-21)"
729,30,Bet,10,0,-10,-10,892,14,878,"2 : Street(7-9),Street(13-15),Street(19-21),Street(22-24),Street(31-33)"
730,1,Bet,14,0,-14,-14,878,18,860,"2 : Street(7-9),Street(10-12),Street(19-21),Street(22-24),Street(28-30) | 2 : Street(31-33),Street(34-36)"
731,29,Bet,18,24,-18,6,884,14,870,"2 : Street(1-3),Street(7-9),Street(10-12),Street(13-15),Street(19-21) | 2 : Street(22-24),Street(25-27),Street(28-30),Street(34-36)"
732,6,Bet,14,0,-14,-14,870,16,854,"2 : Street(1-3),Street(10-12),Street(13-15),Street(19-21),Street(25-27) | 2 : Street(28-30),Street(34-36)"
733,21,Bet,16,24,-16,8,878,8,870,"2 : Street(4-6),Street(7-9),Street(13-15),Street(19-21),Street(25-27) | 2 : Street(28-30),Street(31-33),Street(34-36)"
734,25,Bet,8,0,-8,-8,870,12,858,"2 : Street(4-6),Street(16-18),Street(19-21),Street(28-30)"
735,4,Bet,12,24,-12,12,882,8,874,"2 : Street(4-6),Street(7-9),Street(16-18),Street(19-21),Street(25-27) | 2 : Street(28-30)"
736,28,Bet,8,0,-8,-8,874,12,862,"2 : Street(4-6),Street(7-9),Street(16-18),Street(19-21)"
737,19,Bet,12,24,-12,12,886,8,878,"2 : Street(4-6),Street(7-9),Street(16-18),Street(19-21),Street(25-27) | 2 : Street(28-30)"
738,19,Bet,8,24,-8,16,902,4,898,"2 : Street(4-6),Street(19-21),Street(25-27),Street(28-30)"
739,17,Bet,4,0,-4,-4,898,8,890,"2 : Street(19-21),Street(25-27)"
740,5,Bet,8,24,-8,16,914,8,906,"2 : Street(4-6),Street(16-18),Street(19-21),Street(34-36)"
741,23,Bet,8,0,-8,-8,906,10,896,"2 : Street(4-6),Street(16-18),Street(19-21),Street(28-30)"
742,34,Bet,10,0,-10,-10,896,14,882,"2 : Street(1-3),Street(4-6),Street(16-18),Street(19-21),Street(22-24)"
743,22,Bet,14,24,-14,10,906,8,898,"2 : Street(4-6),Street(13-15),Street(16-18),Street(19-21),Street(22-24) | 2 : Street(25-27),Street(34-36)"
744,11,Bet,8,0,-8,-8,898,12,886,"2 : Street(19-21),Street(22-24),Street(31-33),Street(34-36)"
745,29,Bet,12,0,-12,-12,886,16,870,"2 : Street(7-9),Street(10-12),Street(19-21),Street(22-24),Street(31-33) | 2 : Street(34-36)"
746,3,Bet,16,0,-16,-16,870,18,852,"2 : Street(4-6),Street(10-12),Street(16-18),Street(22-24),Street(25-27) | 2 : Street(28-30),Street(31-33),Street(34-36)"
747,3,Bet,18,24,-18,6,876,12,864,"2 : Street(1-3),Street(4-6),Street(10-12),Street(16-18),Street(22-24) | 2 : Street(25-27),Street(28-30),Street(31-33),Street(34-36)"
748,16,Bet,12,24,-12,12,888,6,882,"2 : Street(1-3),Street(4-6),Street(16-18),Street(25-27),Street(31-33) | 2 : Street(34-36)"
749,11,Bet,6,0,-6,-6,882,10,872,"2 : Street(1-3),Street(13-15),Street(16-18)"
750,31,Bet,10,0,-10,-10,872,12,860,"2 : Street(1-3),Street(10-12),Street(13-15),Street(16-18),Street(28-30)"
751,11,Bet,12,24,-12,12,884,10,874,"2 : Street(1-3),Street(7-9),Street(10-12),Street(16-18),Street(25-27) | 2 : Street(31-33)"
752,32,Bet,10,24,-10,14,898,8,890,"2 : Street(1-3),Street(7-9),Street(10-12),Street(25-27),Street(31-33)"
753,25,Bet,8,0,-8,-8,890,12,878,"2 : Street(4-6),Street(10-12),Street(28-30),Street(31-33)"
754,32,Bet,12,24,-12,12,902,10,892,"2 : Street(1-3),Street(10-12),Street(22-24),Street(25-27),Street(28-30) | 2 : Street(31-33)"
755,19,Bet,10,0,-10,-10,892,12,880,"2 : Street(1-3),Street(22-24),Street(25-27),Street(28-30),Street(31-33)"
756,21,Bet,12,24,-12,12,904,12,892,"2 : Street(10-12),Street(16-18),Street(19-21),Street(22-24),Street(28-30) | 2 : Street(31-33)"
757,15,Bet,12,0,-12,-12,892,14,878,"2 : Street(10-12),Street(16-18),Street(19-21),Street(22-24),Street(28-30) | 2 : Street(31-33)"
758,16,Bet,14,24,-14,10,902,8,894,"2 : Street(7-9),Street(13-15),Street(16-18),Street(19-21),Street(22-24) | 2 : Street(25-27),Street(28-30)"
759,11,Bet,8,0,-8,-8,894,12,882,"2 : Street(7-9),Street(13-15),Street(16-18),Street(19-21)"
760,32,Bet,12,0,-12,-12,882,14,868,"2 : Street(7-9),Street(10-12),Street(13-15),Street(16-18),Street(19-21) | 2 : Street(25-27)"
761,33,Bet,14,24,-14,10,892,8,884,"2 : Street(7-9),Street(10-12),Street(13-15),Street(16-18),Street(19-21) | 2 : Street(25-27),Street(31-33)"
762,22,Bet,8,0,-8,-8,884,12,872,"2 : Street(7-9),Street(19-21),Street(25-27),Street(31-33)"
763,9,Bet,12,24,-12,12,896,4,892,"2 : Street(4-6),Street(7-9),Street(13-15),Street(19-21),Street(22-24) | 2 : Street(31-33)"
764,30,Bet,4,0,-4,-4,892,8,884,"2 : Street(4-6),Street(7-9)"
765,27,Bet,8,0,-8,-8,884,12,872,"2 : Street(1-3),Street(4-6),Street(7-9),Street(28-30)"
766,13,Bet,12,0,-12,-12,872,16,856,"2 : Street(1-3),Street(4-6),Street(7-9),Street(19-21),Street(25-27) | 2 : Street(28-30)"
767,29,Bet,16,24,-16,8,880,12,868,"2 : Street(1-3),Street(4-6),Street(7-9),Street(13-15),Street(16-18) | 2 : Street(19-21),Street(25-27),Street(28-30)"
768,14,Bet,12,0,-12,-12,868,8,860,"2 : Street(1-3),Street(4-6),Street(16-18),Street(19-21),Street(25-27) | 2 : Street(28-30)"
769,1,Bet,8,0,-8,-8,860,10,850,"2 : Street(10-12),Street(13-15),Street(25-27),Street(28-30)"
770,1,Bet,10,24,-10,14,874,8,866,"2 : Street(1-3),Street(10-12),Street(13-15),Street(25-27),Street(28-30)"
771,2,Bet,8,24,-8,16,890,2,888,"2 : Street(1-3),Street(10-12),Street(25-27),Street(28-30)"
772,32,Bet,2,0,-2,-2,888,6,882,2 : Street(1-3)
773,9,Bet,6,0,-6,-6,882,10,872,"2 : Street(1-3),Street(25-27),Street(31-33)"
774,27,Bet,10,24,-10,14,896,10,886,"2 : Street(1-3),Street(4-6),Street(7-9),Street(25-27),Street(31-33)"
775,20,Bet,10,0,-10,-10,886,14,872,"2 : Street(1-3),Street(7-9),Street(22-24),Street(25-27),Street(31-33)"
776,25,Bet,14,24,-14,10,896,8,888,"2 : Street(1-3),Street(7-9),Street(16-18),Street(19-21),Street(22-24) | 2 : Street(25-27),Street(31-33)"
777,11,Bet,8,0,-8,-8,888,10,878,"2 : Street(16-18),Street(19-21),Street(22-24),Street(25-27)"
778,21,Bet,10,0,-10,-10,878,12,866,"2 : Street(4-6),Street(10-12),Street(16-18),Street(22-24),Street(25-27)"
779,3,Bet,12,0,-12,-12,866,18,848,"2 : Street(4-6),Street(10-12),Street(16-18),Street(19-21),Street(22-24) | 2 : Street(25-27)"
780,24,Bet,18,24,-18,6,872,12,860,"2 : Street(4-6),Street(10-12),Street(16-18),Street(19-21),Street(22-24) | 2 : Street(25-27),Street(31-33) | 4 : Street(1-3)"
781,1,Bet,12,24,-12,12,884,6,878,"2 : Street(1-3),Street(10-12),Street(16-18),Street(19-21),Street(22-24) | 2 : Street(25-27)"
782,2,Bet,6,24,-6,18,902,6,896,"2 : Street(1-3),Street(16-18),Street(22-24)"
783,28,Bet,6,0,-6,-6,896,8,888,"2 : Street(1-3),Street(16-18),Street(22-24)"
784,32,Bet,8,0,-8,-8,888,12,876,"2 : Street(1-3),Street(13-15),Street(16-18),Street(28-30)"
785,28,Bet,12,24,-12,12,900,4,896,"2 : Street(1-3),Street(7-9),Street(13-15),Street(16-18),Street(28-30) | 2 : Street(31-33)"
786,22,Bet,4,0,-4,-4,896,8,888,"2 : Street(28-30),Street(31-33)"
787,3,Bet,8,0,-8,-8,888,10,878,"2 : Street(19-21),Street(22-24),Street(25-27),Street(28-30)"
788,12,Bet,10,0,-10,-10,878,14,864,"2 : Street(1-3),Street(19-21),Street(22-24),Street(25-27),Street(28-30)"
789,1,Bet,14,24,-14,10,888,14,874,"2 : Street(1-3),Street(7-9),Street(10-12),Street(19-21),Street(22-24) | 2 : Street(25-27),Street(28-30)"
790,34,Bet,14,0,-14,-14,874,14,860,"2 : Street(1-3),Street(7-9),Street(10-12),Street(19-21),Street(22-24) | 2 : Street(25-27),Street(28-30)"
791,28,Bet,14,0,-14,-14,860,16,844,"2 : Street(1-3),Street(4-6),Street(10-12),Street(16-18),Street(19-21) | 2 : Street(31-33),Street(34-36)"
792,29,Bet,16,24,-16,8,868,16,852,"2 : Street(1-3),Street(4-6),Street(16-18),Street(19-21),Street(22-24) | 2 : Street(28-30),Street(31-33),Street(34-36)"
793,23,Bet,16,24,-16,8,876,6,870,"2 : Street(1-3),Street(4-6),Street(16-18),Street(19-21),Street(22-24) | 2 : Street(28-30),Street(31-33),Street(34-36)"
794,24,Bet,6,24,-6,18,894,4,890,"2 : Street(10-12),Street(22-24),Street(28-30)"
795,11,Bet,4,24,-4,20,914,6,908,"2 : Street(10-12),Street(22-24)"
796,32,Bet,6,0,-6,-6,908,10,898,"2 : Street(1-3),Street(10-12),Street(22-24)"
797,18,Bet,10,0,-10,-10,898,14,884,"2 : Street(10-12),Street(22-24),Street(25-27),Street(31-33),Street(34-36)"
798,32,Bet,14,24,-14,10,908,10,898,"2 : Street(10-12),Street(13-15),Street(16-18),Street(22-24),Street(25-27) | 2 : Street(28-30),Street(31-33)"
799,5,Bet,10,0,-10,-10,898,12,886,"2 : Street(13-15),Street(16-18),Street(25-27),Street(28-30),Street(31-33)"
800,23,Bet,12,24,-12,12,910,8,902,"2 : Street(1-3),Street(4-6),Street(13-15),Street(22-24),Street(25-27) | 2 : Street(31-33)"
801,18,Bet,8,0,-8,-8,902,10,892,"2 : Street(4-6),Street(10-12),Street(22-24),Street(31-33)"
802,21,Bet,10,0,-10,-10,892,12,880,"2 : Street(4-6),Street(10-12),Street(16-18),Street(22-24),Street(31-33)"
803,8,Bet,12,0,-12,-12,880,16,864,"2 : Street(4-6),Street(13-15),Street(16-18),Street(19-21),Street(22-24) | 2 : Street(31-33)"
804,7,Bet,16,24,-16,8,888,10,878,"2 : Street(1-3),Street(4-6),Street(7-9),Street(13-15),Street(16-18) | 2 : Street(19-21),Street(22-24),Street(31-33)"
805,10,Bet,10,0,-10,-10,878,12,866,"2 : Street(1-3),Street(4-6),Street(7-9),Street(13-15),Street(22-24)"
806,17,Bet,12,0,-12,-12,866,8,858,"2 : Street(1-3),Street(7-9),Street(10-12),Street(13-15),Street(22-24) | 2 : Street(31-33)"
807,31,Bet,8,0,-8,-8,858,8,850,"2 : Street(7-9),Street(10-12),Street(16-18),Street(19-21)"
808,18,Bet,8,24,-8,16,874,8,866,"2 : Street(7-9),Street(10-12),Street(16-18),Street(31-33)"
809,35,Bet,8,0,-8,-8,866,10,856,"2 : Street(4-6),Street(7-9),Street(16-18),Street(31-33)"
810,27,Bet,10,0,-10,-10,856,14,842,"2 : Street(10-12),Street(16-18),Street(22-24),Street(28-30),Street(34-36)"
811,26,Bet,14,24,-14,10,866,12,854,"2 : Street(4-6),Street(13-15),Street(16-18),Street(19-21),Street(25-27) | 2 : Street(31-33),Street(34-36)"
812,1,Bet,12,0,-12,-12,854,14,840,"2 : Street(4-6),Street(13-15),Street(19-21),Street(25-27),Street(31-33) | 2 : Street(34-36)"
813,1,Bet,14,24,-14,10,864,2,862,"2 : Street(1-3),Street(7-9),Street(13-15),Street(16-18),Street(22-24) | 2 : Street(25-27),Street(28-30)"
814,29,Bet,2,0,-2,-2,862,6,856,2 : Street(1-3)
815,25,Bet,6,24,-6,18,880,8,872,"2 : Street(1-3),Street(25-27),Street(28-30)"
816,9,Bet,8,0,-8,-8,872,12,860,"2 : Street(1-3),Street(22-24),Street(25-27),Street(28-30)"
817,10,Bet,12,0,-12,-12,860,14,846,"2 : Street(1-3),Street(4-6),Street(7-9),Street(22-24),Street(25-27) | 2 : Street(28-30)"
818,19,Bet,14,0,-14,-14,846,16,830,"2 : Street(1-3),Street(4-6),Street(7-9),Street(10-12),Street(22-24) | 2 : Street(25-27),Street(28-30)"
819,6,Bet,16,0,-16,-16,830,18,812,"2 : Street(1-3),Street(7-9),Street(10-12),Street(16-18),Street(19-21) | 2 : Street(22-24),Street(25-27),Street(28-30)"
820,27,Bet,18,24,-18,6,836,4,832,"2 : Street(1-3),Street(4-6),Street(7-9),Street(10-12),Street(16-18) | 2 : Street(19-21),Street(22-24),Street(25-27),Street(28-30)"
821,11,Bet,4,0,-4,-4,832,8,824,"2 : Street(7-9),Street(25-27)"
822,1,Bet,8,0,-8,-8,824,12,812,"2 : Street(7-9),Street(10-12),Street(19-21),Street(25-27)"
823,2,Bet,12,24,-12,12,836,8,828,"2 : Street(1-3),Street(4-6),Street(10-12),Street(19-21),Street(25-27) | 2 : Street(28-30)"
824,25,Bet,8,0,-8,-8,828,12,816,"2 : Street(1-3),Street(4-6),Street(19-21),Street(28-30)"
825,5,Bet,12,24,-12,12,840,8,832,"2 : Street(1-3),Street(4-6),Street(10-12),Street(19-21),Street(25-27) | 2 : Street(28-30)"
826,4,Bet,8,24,-8,16,856,4,852,"2 : Street(1-3),Street(4-6),Street(10-12),Street(25-27)"
827,18,Bet,4,0,-4,-4,852,8,844,"2 : Street(4-6),Street(10-12)"
828,11,Bet,8,0,-8,-8,844,12,832,"2 : Street(1-3),Street(4-6),Street(13-15),Street(16-18)"
829,5,Bet,12,24,-12,12,856,10,846,"2 : Street(1-3),Street(4-6),Street(10-12),Street(13-15),Street(16-18) | 2 : Street(25-27)"
830,10,Bet,10,0,-10,-10,846,12,834,"2 : Street(1-3),Street(4-6),Street(13-15),Street(16-18),Street(25-27)"
831,14,Bet,12,24,-12,12,858,8,850,"2 : Street(1-3),Street(4-6),Street(10-12),Street(13-15),Street(16-18) | 2 : Street(25-27)"
832,13,Bet,8,24,-8,16,874,4,870,"2 : Street(4-6),Street(10-12),Street(13-15),Street(28-30)"
833,5,Bet,4,0,-4,-4,870,8,862,"2 : Street(13-15),Street(28-30)"
834,34,Bet,8,0,-8,-8,862,10,852,"2 : Street(4-6),Street(10-12),Street(13-15),Street(28-30)"
835,33,Bet,10,24,-10,14,876,10,866,"2 : Street(4-6),Street(7-9),Street(13-15),Street(31-33),Street(34-36)"
836,25,Bet,10,0,-10,-10,866,14,852,"2 : Street(4-6),Street(13-15),Street(22-24),Street(31-33),Street(34-36)"
837,9,Bet,14,0,-14,-14,852,18,834,"2 : Street(4-6),Street(13-15),Street(16-18),Street(22-24),Street(25-27) | 2 : Street(31-33),Street(34-36)"
838,31,Bet,18,24,-18,6,858,0,858,"2 : Street(4-6),Street(7-9),Street(10-12),Street(13-15),Street(19-21) | 2 : Street(22-24),Street(25-27),Street(31-33),Street(34-36)"
